*
* Connector Definitions
* Module: RA
* Description: Look up for reciprocal and reciprocal square root
* Revision: 
* Date: 
* 
ZAA ZAB - IAP .
ZAC ZAD - OAZ .
ZAE ZAF - OBZ .
ZAG ZAH - ICD .
ZAI ZAJ - OED .
ZAK ZAL - OFD .
ZAM ZAN - ODJ .
ZAO ZAP - OAJ .
ZAQ ZAR - OBJ .
ZAS ZAT - OCJ .
ZAU ZAV - IAN .
ZAW ZAX - OAX .
ZBA ZBB - OBX .
ZBC ZBD - ODA .
ZBE ZBF - OAA .
ZBG ZBH - OBA .
ZBI ZBJ - OCA .
ZBK ZBL - IAE .
ZBM ZBN - OAO .
ZBO ZBP - OBO .
ZBQ ZBR - IRA .
ZBS ZBT - OIG .
ZBU ZBV - IAG .
ZBW ZBX - OAQ .
ZCA ZCB - OBQ .
ZCC ZCD - ICM .
ZCE ZCF - OEM .
ZCG ZCH - OFM .
ZCI ZCJ - IPA .
ZCK ZCL - IPB .
ZCM ZCN - ICE .
ZCO ZCP - OEE .
ZCQ ZCR - OFE .
ZCS ZCT - ICJ .
ZCU ZCV - ICI .
ZCW ZCX - ICF .
       	 
ZDA ZDB - OCB .
ZDC ZDD - OAI .
ZDE ZDF - OCZ .
ZDG ZDH - ODZ .
ZDI ZDJ - IQB .
ZDK ZDL - ICB .
ZDM ZDN - OEB .
ZDO ZDP - OFB .
ZDQ ZDR - ODH .
ZDS ZDT - OAH .
ZDU ZDV - OBH .
ZDW ZDX - OCH .
ZEA ZEB - OCX .
ZEC ZED - ONA .
ZEE ZEF - OCO .
ZEG ZEH - ODO .
ZEI ZEJ - OIE .
ZEK ZEL - OCQ .
ZEM ZEN - ODQ .
ZEO ZEP - ICO .
ZEQ ZER - OEO .
ZES ZET - OFO .
ZEU ZEV - IQC .
ZEW ZEX - ODX .
ZFA ZFB - ICK .
ZFC ZFD - OEK .
ZFE ZFF - OFK .
ZFG ZFH - ICG .
ZFI ZFJ - ICH .
ZFK ZFL - ICL .
ZFM ZFN - OEH .
ZFO ZFP - OFH .
ZFQ ZFR - OFJ .
ZFS ZFT - ICN .
ZFU ZFV - OEJ .
ZFW ZFX - ILE .
       
ZGA ZGB - ILF .
ZGC ZGD - OIH .
ZGE ZGF - IAH .
ZGG ZGH - OAR .
ZGI ZGJ - OBR .
ZGK ZGL - OEN .
ZGM ZGN - OFN .
ZGO ZGP - ODB .
ZGQ ZGR - OAB .
ZGS ZGT - OBB .
ZGU ZGV - IAF .
ZGW ZGX - OBP .
ZHA ZHB - OAP .
ZHC ZHD - ODI .
ZHE ZHF - OBI .
ZHG ZHH - OCI .
ZHI ZHJ - IAM .
ZHK ZHL - OAW .
ZHM ZHN - OBW .
ZHO ZHP - IAO .
ZHQ ZHR - OBY .
ZHS ZHT - OAY .
ZHU ZHV - OLA .
ZHW ZHX - ILA .
ZIA ZIB - ICC .
ZIC ZID - OEC .
ZIE ZIF - OMA .
ZIG ZIH - OLB .
ZII ZIJ - ILB .
ZIK ZIL - OEI .
ZIM ZIN - OFI .
ZIO ZIP - OEF .
ZIQ ZIR - OFF .
ZIS ZIT - IAB .
ZIU ZIV - IAC .
ZIW ZIX - *** .
       
ZJA ZJB - OIF .
ZJC ZJD - OCR .
ZJE ZJF - ODR .
ZJG ZJH - IQA .
ZJI ZJJ - *** .
ZJK ZJL - OEP .
ZJM ZJN - IAI .
ZJO ZJP - OCP .
ZJQ ZJR - ODG .
ZJS ZJT - OAG .
ZJU ZJV - OBG .
ZJW ZJX - OCG .
ZKA ZKB - OCW .
ZKC ZKD - ODW .
ZKE ZKF - OIM .
ZKG ZKH - OCY .
ZKI ZKJ - ODY .
ZKK ZKL - OLC .
ZKM ZKN - ILC .
ZKO ZKP - ICA .
ZKQ ZKR - IKA .
ZKS ZKT - OFA .
ZKU ZKV - OLD .
ZKW ZKX - ILD .
ZLA ZLB - ODP .
ZLC ZLD - ILI .
ZLE ZLF - OFG .
ZLG ZLH - *** .
ZLI ZLJ - OFL .
ZLK ZLL - OLE .
ZLM ZLN - OLF .
ZLO ZLP - OAL .
ZLQ ZLR - *** .
ZLS ZLT - OGD .
ZLU ZLV - *** .
ZLW ZLX - IAL .
       
ZMA ZMB - ICP .
ZMC ZMD - *** .
ZME ZMF - OBF .
ZMG ZMH - OBL .
ZMI ZMJ - OBM .
ZMK ZML - *** .
ZMM ZMN - OFP .
ZMO ZMP - *** .
ZMQ ZMR - OGM .
ZMS ZMT - *** .
ZMU ZMV - *** .
ZMW ZMX - OAF .
ZNA ZNB - *** .
ZNC ZND - *** .
ZNE ZNF - OHE .
ZNG ZNH - *** .
ZNI ZNJ - ODF .
ZNK ZNL - OKA .
ZNM ZNN - *** .
ZNO ZNP - OHM .
ZNQ ZNR - OEA .
ZNS ZNT - OAM .
ZNU ZNV - OEG .
ZNW ZNX - *** .
ZOA ZOB - OEL .
ZOC ZOD - OIC .
ZOE ZOF - OIL .
ZOG ZOH - *** .
ZOI ZOJ - *** .
ZOK ZOL - OBS .
ZOM ZON - OBV .
ZOO ZOP - OGJ .
ZOQ ZOR - *** .
ZOS ZOT - *** .
ZOU ZOV - OCF .
ZOW ZOX - *** .
       
ZPA ZPB - OIB .
ZPC ZPD - OCV .
ZPE ZPF - ODV .
ZPG ZPH - OGB .
ZPI ZPJ - OHB .
ZPK ZPL - IRB .
ZPM ZPN - OCL .
ZPO ZPP - ODL .
ZPQ ZPR - OKB .
ZPS ZPT - OKC .
ZPU ZPV - ODC .
ZPW ZPX - OAC .
ZQA ZQB - OBC .
ZQC ZQD - OCC .
ZQE ZQF - OCM .
ZQG ZQH - ODM .
ZQI ZQJ - OII .
ZQK ZQL - OCS .
ZQM ZQN - ODS .
ZQO ZQP - ILG .
ZQQ ZQR - OLG .
ZQS ZQT - OGO .
ZQU ZQV - OHO .
ZQW ZQX - OLH .
ZRA ZRB - ILH .
ZRC ZRD - OGK .
ZRE ZRF - OHK .
ZRG ZRH - OGH .
ZRI ZRJ - OHH .
ZRK ZRL - *** .
ZRM ZRN - *** .
ZRO ZRP - *** .
ZRQ ZRR - *** .
ZRS ZRT - IJA .
ZRU ZRV - *** .
ZRW ZRX - OHD .
     
ZSA ZSB - OLI .
ZSC ZSD - OFC .
ZSE ZSF - OID .
ZSG ZSH - IAJ .
ZSI ZSJ - OBT .
ZSK ZSL - OAT .
ZSM ZSN - OGN .
ZSO ZSP - OHN .
ZSQ ZSR - ISA .
ZSS ZST - IAD .
ZSU ZSV - OAN .
ZSW ZSX - OKD .
ZTA ZTB - OKE .
ZTC ZTD - ODE .
ZTE ZTF - OAE .
ZTG ZTH - OBE .
ZTI ZTJ - OCE .
ZTK ZTL - IAA .
ZTM ZTN - OAK .
ZTO ZTP - OBK .
ZTQ ZTR - OIK .
ZTS ZTT - IAK .
ZTU ZTV - OAU .
ZTW ZTX - OBU .
ZUA ZUB - IGA .
ZUC ZUD - OJA .
ZUE ZUF - OGC .
ZUG ZUH - OHC .
ZUI ZUJ - OBN .
ZUK ZUL - OGI .
ZUM ZUN - OHI .
ZUO ZUP - OGF .
ZUQ ZUR - OHF .
ZUS ZUT - OHJ .
ZUU ZUV - *** .
ZUW ZUX - OAS .
     
ZVA ZVB - OIJ .
ZVC ZVD - OCT .
ZVE ZVF - ODT .
ZVG ZVH - OGP .
ZVI ZVJ - OHP .
ZVK ZVL - ODD .
ZVM ZVN - OAD .
ZVO ZVP - OBD .
ZVQ ZVR - OCD .
ZVS ZVT - OCN .
ZVU ZVV - ODN .
ZVW ZVX - OKF .
ZWA ZWB - OKG .
ZWC ZWD - OCK .
ZWE ZWF - ODK .
ZWG ZWH - OIA .
ZWI ZWJ - OCU .
ZWK ZWL - ODU .
ZWM ZWN - OGA .
ZWO ZWP - OGL .
ZWQ ZWR - OHA .
ZWS ZWT - OGG .
ZWU ZWV - OHL .
ZWW ZWX - OHG .
ZXA ZXB - *** .
ZXC ZXD - *** .
ZXE ZXF - OGE .
ZXG ZXH - *** .
ZXI ZXJ - OAV .
ZXK ZXL - *** .
ZXM ZXN - *** .
ZXO ZXP - *** .
ZXQ ZXR - *** .
ZXS ZXT - *** .
ZXU ZXV - *** .
ZXW ZXX - *** . 

