*
* Connector Definitions
* Module: ME
* Description: Floating multiply, reciprocal, reciprocal square root
* Revision: 
* Date: 
*
ZAA ZAB - IHA .
ZAC ZAD - IVB .
ZAE ZAF - IVD .
ZAG ZAH - IVA .
ZAI ZAJ - IVC .
ZAK ZAL - IVF .
ZAM ZAN - IVE .
ZAO ZAP - ODC .
ZAQ ZAR - ODA .
ZAS ZAT - ODB .
ZAU ZAV - OEA .
ZAW ZAX - OEB .
ZBA ZBB - OEC .
ZBC ZBD - OBI .
ZBE ZBF - IBZ .
ZBG ZBH - IDZ .
ZBI ZBJ - IGA .
ZBK ZBL - IGB .
ZBM ZBN - IHB .
ZBO ZBP - IBY .
ZBQ ZBR - IAC .
ZBS ZBT - ICE .
ZBU ZBV - IAD .
ZBW ZBX - IAE .
ZCA ZCB - ICD .
ZCC ZCD - OAA .
ZCE ZCF - OAB .
ZCG ZCH - ICU .
ZCI ZCJ - IAT .
ZCK ZCL - IAU .
ZCM ZCN - ICT .
ZCO ZCP - OBJ .
ZCQ ZCR - OAQ .
ZCS ZCT - OAR .
ZCU ZCV - IDK .
ZCW ZCX - IBJ .
       	  
ZDA ZDB - OMA .
ZDC ZDD - OGA .
ZDE ZDF - OGB .
ZDG ZDH - OGC .
ZDI ZDJ - IDY .
ZDK ZDL - IBX .
ZDM ZDN - IBV .
ZDO ZDP - IDX .
ZDQ ZDR - OCA .
ZDS ZDT - OCB .
ZDU ZDV - OCC .
ZDW ZDX - OCD .
ZEA ZEB - IUA .
ZEC ZED - IHD .
ZEE ZEF - IGC .
ZEG ZEH - IGD .
ZEI ZEJ - IHC .
ZEK ZEL - IAB .
ZEM ZEN - OAO .
ZEO ZEP - OAP .
ZEQ ZER - IAR .
ZES ZET - IAS .
ZEU ZEV - ICS .
ZEW ZEX - OBG .
ZFA ZFB - OBH .
ZFC ZFD - IDI .
ZFE ZFF - IBH .
ZFG ZFH - IBI .
ZFI ZFJ - IDH .
ZFK ZFL - OBW .
ZFM ZFN - OBX .
ZFO ZFP - IBK .
ZFQ ZFR - IDJ .
ZFS ZFT - *** .
ZFU ZFV - *** .
ZFW ZFX - *** .
       
ZGA ZGB - OKA .
ZGC ZGD - OBK .
ZGE ZGF - OBL .
ZGG ZGH - OMC .
ZGI ZGJ - IUB .
ZGK ZGL - IHF .
ZGM ZGN - IGE .
ZGO ZGP - IGF .
ZGQ ZGR - IHE .
ZGS ZGT - *** .
ZGU ZGV - OAC .
ZGW ZGX - OAD .
ZHA ZHB - IAF .
ZHC ZHD - ICF .
ZHE ZHF - IFF .
ZHG ZHH - IEF .
ZHI ZHJ - IAQ .
ZHK ZHL - ICQ .
ZHM ZHN - IEQ .
ZHO ZHP - ICW .
ZHQ ZHR - IAV .
ZHS ZHT - IAW .
ZHU ZHV - ICV .
ZHW ZHX - OAS .
ZIA ZIB - OAT .
ZIC ZID - IDM .
ZIE ZIF - IBL .
ZIG ZIH - IBM .
ZII ZIJ - IDL .
ZIK ZIL - *** .
ZIM ZIN - *** .
ZIO ZIP - *** .
ZIQ ZIR - ICC .
ZIS ZIT - ICB .
ZIU ZIV - *** .
ZIW ZIX - *** .
       
ZJA ZJB - OFA .
ZJC ZJD - OFB .
ZJE ZJF - OFC .
ZJG ZJH - IDW .
ZJI ZJJ - *** .
ZJK ZJL - IBW .
ZJM ZJN - IDV .
ZJO ZJP - OCE .
ZJQ ZJR - OCF .
ZJS ZJT - OCG .
ZJU ZJV - OCH .
ZJW ZJX - OBU .
ZKA ZKB - OBV .
ZKC ZKD - IHH .
ZKE ZKF - IGG .
ZKG ZKH - IGH .
ZKI ZKJ - IHG .
ZKK ZKL - IAG .
ZKM ZKN - ICG .
ZKO ZKP - IEG .
ZKQ ZKR - IAP .
ZKS ZKT - ICP .
ZKU ZKV - IEP .
ZKW ZKX - OAM .
ZLA ZLB - OAN .
ZLC ZLD - IDG .
ZLE ZLF - IBF .
ZLG ZLH - IBG .
ZLI ZLJ - IDF .
ZLK ZLL - OBE .
ZLM ZLN - OBF .
ZLO ZLP - *** .
ZLQ ZLR - *** .
ZLS ZLT - *** .
ZLU ZLV - *** .
ZLW ZLX - *** .
       
ZMA ZMB - OJD .
ZMC ZMD - OJE .
ZME ZMF - OJF .
ZMG ZMH - OID .
ZMI ZMJ - OIA .
ZMK ZML - OIB .
ZMM ZMN - OIC .
ZMO ZMP - OBM .
ZMQ ZMR - IHJ .
ZMS ZMT - IGI .
ZMU ZMV - IGJ .
ZMW ZMX - IHI .
ZNA ZNB - OAE .
ZNC ZND - OAF .
ZNE ZNF - IAH .
ZNG ZNH - ICH .
ZNI ZNJ - IEH .
ZNK ZNL - IAO .
ZNM ZNN - ICO .
ZNO ZNP - IEO .
ZNQ ZNR - ICY .
ZNS ZNT - IAX .
ZNU ZNV - IAY .
ZNW ZNX - ICX .
ZOA ZOB - OBN .
ZOC ZOD - OAU .
ZOE ZOF - OAV .
ZOG ZOH - IDO .
ZOI ZOJ - IBN .
ZOK ZOL - IBO .
ZOM ZON - IDN .
ZOO ZOP - *** .
ZOQ ZOR - *** .
ZOS ZOT - *** .
ZOU ZOV - *** .
ZOW ZOX - *** .
       
ZPA ZPB - OHB .
ZPC ZPD - OHC .
ZPE ZPF - OHA .
ZPG ZPH - OJC .
ZPI ZPJ - IDU .
ZPK ZPL - IBT .
ZPM ZPN - IBU .
ZPO ZPP - IDT .
ZPQ ZPR - OCI .
ZPS ZPT - OCJ .
ZPU ZPV - OCK .
ZPW ZPX - OCL .
ZQA ZQB - IHL .
ZQC ZQD - IGK .
ZQE ZQF - IGL .
ZQG ZQH - IHK .
ZQI ZQJ - OAK .
ZQK ZQL - OAL .
ZQM ZQN - *** .
ZQO ZQP - IAI .
ZQQ ZQR - ICI .
ZQS ZQT - IEI .
ZQU ZQV - IAN .
ZQW ZQX - ICN .
ZRA ZRB - IFO .
ZRC ZRD - OBC .
ZRE ZRF - OBD .
ZRG ZRH - IDE .
ZRI ZRJ - IBD .
ZRK ZRL - IBE .
ZRM ZRN - IDD .
ZRO ZRP - OBS .
ZRQ ZRR - OBT .
ZRS ZRT - *** .
ZRU ZRV - *** .
ZRW ZRX - *** .
     
ZSA ZSB - OMB .
ZSC ZSD - OJB .
ZSE ZSF - OBO .
ZSG ZSH - OBP .
ZSI ZSJ - OLA .
ZSK ZSL - IHN .
ZSM ZSN - IGM .
ZSO ZSP - IGN .
ZSQ ZSR - IHM .
ZSS ZST - IAJ .
ZSU ZSV - IAK .
ZSW ZSX - ICK .
ZTA ZTB - OAG .
ZTC ZTD - OAH .
ZTE ZTF - IDA .
ZTG ZTH - IAZ .
ZTI ZTJ - IBA .
ZTK ZTL - ICZ .
ZTM ZTN - OAW .
ZTO ZTP - OAX .
ZTQ ZTR - IDQ .
ZTS ZTT - IBP .
ZTU ZTV - IBQ .
ZTW ZTX - IDP .
ZUA ZUB - *** .
ZUC ZUD - *** .
ZUE ZUF - *** .
ZUG ZUH - *** .
ZUI ZUJ - *** .
ZUK ZUL - *** .
ZUM ZUN - *** .
ZUO ZUP - *** .
ZUQ ZUR - *** .
ZUS ZUT - *** .
ZUU ZUV - *** .
ZUW ZUX - *** .
     
ZVA ZVB - OMD .
ZVC ZVD - OJA .
ZVE ZVF - QLN .
ZVG ZVH - IDS .
ZVI ZVJ - IBR .
ZVK ZVL - IDR .
ZVM ZVN - OCM .
ZVO ZVP - OCN .
ZVQ ZVR - OCO .
ZVS ZVT - OCP .
ZVU ZVV - IHP .
ZVW ZVX - IGO .
ZWA ZWB - IGP .
ZWC ZWD - IHO .
ZWE ZWF - OAI .
ZWG ZWH - OAJ .
ZWI ZWJ - ICM .
ZWK ZWL - IAL .
ZWM ZWN - IAM .
ZWO ZWP - ICL .
ZWQ ZWR - OBA .
ZWS ZWT - OBB .
ZWU ZWV - IBS .
ZWW ZWX - *** .
ZXA ZXB - IBB .
ZXC ZXD - IBC .
ZXE ZXF - IDB .
ZXG ZXH - OBQ .
ZXI ZXJ - OBR .
ZXK ZXL - *** .
ZXM ZXN - *** .
ZXO ZXP - *** .
ZXQ ZXR - *** .
ZXS ZXT - *** .
ZXU ZXV - *** .
ZXW ZXX - *** .      
