*
* Connector Definitions
* Module: EB
* Description: Foreground Processor Port
* Revision:
* Date:
*
ZAA ZAB - IAA .
ZAC ZAD - IAB .
ZAE ZAF - IAC .
ZAG ZAH - IAD .
ZAI ZAJ - IAE .
ZAK ZAL - IAF .
ZAM ZAN - IAG .
ZAO ZAP - IAH .
ZAQ ZAR - IAJ .
ZAS ZAT - IAK .
ZAU ZAV - IAL .
ZAW ZAX - IAM .
ZBA ZBB - IAN .
ZBC ZBD - IAO .
ZBE ZBF - IAP .
ZBG ZBH - IBA .
ZBI ZBJ - IBB .
ZBK ZBL - IBC .
ZBM ZBN - IBD .
ZBO ZBP - IBE .
ZBQ ZBR - IBF .
ZBS ZBT - IBG .
ZBU ZBV - IBH .
ZBW ZBX - IBI .
ZCA ZCB - IBJ .
ZCC ZCD - IBK .
ZCE ZCF - IBL .
ZCG ZCH - IBM .
ZCI ZCJ - IBN .
ZCK ZCL - IBO .
ZCM ZCN - IBP .
ZCO ZCP - ICA .
ZCQ ZCR - ICB .
ZCS ZCT - ICC .
ZCU ZCV - ICD .
ZCW ZCX - ICE .

ZDA ZDB - ICF .
ZDC ZDD - ICG .
ZDE ZDF - ICH .
ZDG ZDH - ICI .
ZDI ZDJ - ICJ .
ZDK ZDL - ICK .
ZDM ZDN - ICL .
ZDO ZDP - ICM .
ZDQ ZDR - ICN .
ZDS ZDT - ICO .
ZDU ZDV - ICP .
ZDW ZDX - IDA .
ZEA ZEB - IDB .
ZEC ZED - IDC .
ZEE ZEF - IDD .
ZEG ZEH - IDE .
ZEI ZEJ - IDF .
ZEK ZEL - IDG .
ZEM ZEN - IDH .
ZEO ZEP - IDI .
ZEQ ZER - IDJ .
ZES ZET - IDK .
ZEU ZEV - IDL .
ZEW ZEX - IDM .
ZFA ZFB - IDN .
ZFC ZFD - IDO .
ZFE ZFF - IDP .
ZFG ZFH - IEA .
ZFI ZFJ - IEB .
ZFK ZFL - IEC .
ZFM ZFN - IED .
ZFO ZFP - IEE .
ZFQ ZFR - IEF .
ZFS ZFT - IEG .
ZFU ZFV - IEH .
ZFW ZFX - IEI .

ZGA ZGB - IEJ .
ZGC ZGD - IEK .
ZGE ZGF - IEL .
ZGG ZGH - IEM .
ZGI ZGJ - IEN .
ZGK ZGL - IEO .
ZGM ZGN - IEP .
ZGO ZGP - IFA .
ZGQ ZGR - IFB .
ZGS ZGT - IFC .
ZGU ZGV - IFD .
ZGW ZGX - IFE .
ZHA ZHB - IFF .
ZHC ZHD - IFG .
ZHE ZHF - IFH .
ZHG ZHH - IFI .
ZHI ZHJ - IFJ .
ZHK ZHL - IFK .
ZHM ZHN - IFL .
ZHO ZHP - IFM .
ZHQ ZHR - IFN .
ZHS ZHT - IFO .
ZHU ZHV - IGA .
ZHW ZHX - IGB .
ZIA ZIB - IGC .
ZIC ZID - IGD .
ZIE ZIF - IGE .
ZIG ZIH - IGF .
ZII ZIJ - IGG .
ZIK ZIL - IGH .
ZIM ZIN - IJA .
ZIO ZIP - IHA .
ZIQ ZIR - IHB .
ZIS ZIT - IHC .
ZIU ZIV - IIA .
ZIW ZIX - IIB .

ZJA ZJB - IJB .
ZJC ZJD - IKA .
ZJE ZJF - IKB .
ZJG ZJH - IKC .
ZJI ZJJ - IKD .
ZJK ZJL - IKE .
ZJM ZJN - IKF .
ZJO ZJP - IKG .
ZJQ ZJR - IKH .
ZJS ZJT - IKI .
ZJU ZJV - IKJ .
ZJW ZJX - IKK .
ZKA ZKB - IKL .
ZKC ZKD - IKM .
ZKE ZKF - IKN .
ZKG ZKH - IKO .
ZKI ZKJ - IKP .
ZKK ZKL - IKQ .
ZKM ZKN - IKR .
ZKO ZKP - IKS .
ZKQ ZKR - IKT .
ZKS ZKT - IMA .
ZKU ZKV - INA .
ZKW ZKX - INB .
ZLA ZLB - INC .
ZLC ZLD - IND        .
ZLE ZLF - OAA .
ZLG ZLH - OAB .
ZLI ZLJ - OAC .
ZLK ZLL - OAD .
ZLM ZLN - OAE .
ZLO ZLP - OAJ .
ZLQ ZLR - OAF .
ZLS ZLT - OAG .
ZLU ZLV - OAH .
ZLW ZLX - OAI .

ZMA ZMB - OAK .
ZMC ZMD - OAL .
ZME ZMF - OAM .
ZMG ZMH - OAN .
ZMI ZMJ - OAO .
ZMK ZML - OAP .
ZMM ZMN - OBA .
ZMO ZMP - OBB .
ZMQ ZMR - OBC .
ZMS ZMT - OBD .
ZMU ZMV - OBE .
ZMW ZMX - OBF .
ZNA ZNB - OBG .
ZNC ZND - OBH .
ZNE ZNF - OBI .
ZNG ZNH - OBJ .
ZNI ZNJ - OBK .
ZNK ZNL - OBL .
ZNM ZNN - OBM .
ZNO ZNP - OBN .
ZNQ ZNR - OBO .
ZNS ZNT - OBP .
ZNU ZNV - OCA .
ZNW ZNX - OCB .
ZOA ZOB - OCC .
ZOC ZOD - OCD .
ZOE ZOF - OCE .
ZOG ZOH - OCF .
ZOI ZOJ - OCG .
ZOK ZOL - OCH .
ZOM ZON - OCI .
ZOO ZOP - OCJ .
ZOQ ZOR - OCN .
ZOS ZOT - OCK .
ZOU ZOV - OCL .
ZOW ZOX - OCM .

ZPA ZPB - OCO .
ZPC ZPD - OCP .
ZPE ZPF - ODA .
ZPG ZPH - ODB .
ZPI ZPJ - ODC .
ZPK ZPL - ODD .
ZPM ZPN - ODE .
ZPO ZPP - ODF .
ZPQ ZPR - ODG .
ZPS ZPT - ODH .
ZPU ZPV - ODI .
ZPW ZPX - ODJ .
ZQA ZQB - ODK .
ZQC ZQD - ODL .
ZQE ZQF - ODM .
ZQG ZQH - ODN .
ZQI ZQJ - ODO .
ZQK ZQL - ODP .
ZQM ZQN - OEA .
ZQO ZQP - OEB .
ZQQ ZQR - OEC .
ZQS ZQT - OED .
ZQU ZQV - OEE .
ZQW ZQX - OEF .
ZRA ZRB - OEG .
ZRC ZRD - OEH .
ZRE ZRF - OEI .
ZRG ZRH - OEJ .
ZRI ZRJ - OEK .
ZRK ZRL - OEL .
ZRM ZRN - OEM .
ZRO ZRP - OEN .
ZRQ ZRR - OEO .
ZRS ZRT - OFB .
ZRU ZRV - OEP .
ZRW ZRX - OFA .

ZSA ZSB - OFC .
ZSC ZSD - OFD .
ZSE ZSF - OFE .
ZSG ZSH - OFF .
ZSI ZSJ - OFG .
ZSK ZSL - OFH .
ZSM ZSN - OFI .
ZSO ZSP - OFJ .
ZSQ ZSR - OFK .
ZSS ZST - OFL .
ZSU ZSV - OFM .
ZSW ZSX - OFN .
ZTA ZTB - OFO .
ZTC ZTD - OFP .
ZTE ZTF - OGA .
ZTG ZTH - OGB .
ZTI ZTJ - OGC .
ZTK ZTL - OGD .
ZTM ZTN - OGE .
ZTO ZTP - OGF .
ZTQ ZTR - OHA .
ZTS ZTT - OHB .
ZTU ZTV - OHC .
ZTW ZTX - OHD .
ZUA ZUB - OHE .
ZUC ZUD - OHF .
ZUE ZUF - OHG .
ZUG ZUH - OKA .
ZUI ZUJ - OKI .
ZUK ZUL - OKB .
ZUM ZUN - OKC .
ZUO ZUP - OKD .
ZUQ ZUR - OKE .
ZUS ZUT - OKF .
ZUU ZUV - OKG .
ZUW ZUX - OKH .

ZVA ZVB - OKJ .
ZVC ZVD - OKK .
ZVE ZVF - OKL .
ZVG ZVH - OKM .
ZVI ZVJ - OKN .
ZVK ZVL - OKO .
ZVM ZVN - OKP .
ZVO ZVP - OKQ .
ZVQ ZVR - OKR .
ZVS ZVT - OKS .
ZVU ZVV - OKT .
ZVW ZVX - OLA .
ZWA ZWB - OLB .
ZWC ZWD - OLC .
ZWE ZWF - OLD .
ZWG ZWH - OLE .
ZWI ZWJ - OLF .
ZWK ZWL - OLG .
ZWM ZWN - OLH .
ZWO ZWP - *** .
ZWQ ZWR - *** .
ZWS ZWT - *** .
ZWU ZWV - *** .
ZWW ZWX - *** .
ZXA ZXB - *** .
ZXC ZXD - *** .
ZXE ZXF - *** .
ZXG ZXH - *** .
ZXI ZXJ - *** .
ZXK ZXL - *** .
ZXM ZXN - *** .
ZXO ZXP - *** .
ZXQ ZXR - *** .
ZXS ZXT - *** .
ZXU ZXV - *** .
ZXW ZXX - *** .
