*
* Connector Definitions
* Module: TD
* Description: Memory interface modules, packetize address and data, SECDED
* Revision:
* Date: 
*
ZAA ZAB - OBA .
ZAC ZAD - OFA .
ZAE ZAF - ODA .
ZAG ZAH - OHA .
ZAI ZAJ - OBI .
ZAK ZAL - OFI .
ZAM ZAN - ODI .
ZAO ZAP - OHI .
ZAQ ZAR - IAA .
ZAS ZAT - IBA .
ZAU ZAV - ICA .
ZAW ZAX - IDA .
ZBA ZBB - IAI .
ZBC ZBD - IBI .
ZBE ZBF - ICI .
ZBG ZBH - IDI .
ZBI ZBJ - IAQ .
ZBK ZBL - IBQ .
ZBM ZBN - ICQ .
ZBO ZBP - IDQ .
ZBQ ZBR - OMA .
ZBS ZBT - OIA .
ZBU ZBV - OKA .
ZBW ZBX - OLA .
ZCA ZCB - OAA .
ZCC ZCD - OEA .
ZCE ZCF - OCA .
ZCG ZCH - OGA .
ZCI ZCJ - OAI .
ZCK ZCL - OEI .
ZCM ZCN - OCI .
ZCO ZCP - OGI .
ZCQ ZCR - IEA .
ZCS ZCT - IFA .
ZCU ZCV - IGA .
ZCW ZCX - IHA .
       	 
ZDA ZDB - OBB .
ZDC ZDD - OFB .
ZDE ZDF - ODB .
ZDG ZDH - OBJ .
ZDI ZDJ - ODJ .
ZDK ZDL - OHJ .
ZDM ZDN - IAB .
ZDO ZDP - IBB .
ZDQ ZDR - ICB .
ZDS ZDT - IDB .
ZDU ZDV - IAJ .
ZDW ZDX - IBJ .
ZEA ZEB - ICJ .
ZEC ZED - IDJ .
ZEE ZEF - OFJ .
ZEG ZEH - IAR .
ZEI ZEJ - IBR .
ZEK ZEL - ICR .
ZEM ZEN - IDR .
ZEO ZEP - OMB .
ZEQ ZER - OIB .
ZES ZET - OKB .
ZEU ZEV - OLB .
ZEW ZEX - OHB .
ZFA ZFB - OAB .
ZFC ZFD - OEB .
ZFE ZFF - OCB .
ZFG ZFH - OGB .
ZFI ZFJ - OAJ .
ZFK ZFL - OEJ .
ZFM ZFN - OCJ .
ZFO ZFP - OGJ .
ZFQ ZFR - IEB .
ZFS ZFT - IFB .
ZFU ZFV - IGB .
ZFW ZFX - IHB .
       
ZGA ZGB - OBC .
ZGC ZGD - OFC .
ZGE ZGF - ODC .
ZGG ZGH - OBK .
ZGI ZGJ - ODK .
ZGK ZGL - OHK .
ZGM ZGN - IAC .
ZGO ZGP - IBC .
ZGQ ZGR - ICC .
ZGS ZGT - IDC .
ZGU ZGV - IAK .
ZGW ZGX - IBK .
ZHA ZHB - ICK .
ZHC ZHD - IDK .
ZHE ZHF - OFK .
ZHG ZHH - IAS .
ZHI ZHJ - IBS .
ZHK ZHL - ICS .
ZHM ZHN - IDS .
ZHO ZHP - OMC .
ZHQ ZHR - OIC .
ZHS ZHT - OKC .
ZHU ZHV - OLC .
ZHW ZHX - OHC .
ZIA ZIB - OAC .
ZIC ZID - OEC .
ZIE ZIF - OCC .
ZIG ZIH - OGC .
ZII ZIJ - OAK .
ZIK ZIL - OEK .
ZIM ZIN - OCK .
ZIO ZIP - OGK .
ZIQ ZIR - IEC .
ZIS ZIT - IFC .
ZIU ZIV - IGC .
ZIW ZIX - IHC .
       
ZJA ZJB - OBD .
ZJC ZJD - OFD .
ZJE ZJF - ODD .
ZJG ZJH - OBL .
ZJI ZJJ - OFL .
ZJK ZJL - ODL .
ZJM ZJN - OHL .
ZJO ZJP - IAD .
ZJQ ZJR - IBD .
ZJS ZJT - ICD .
ZJU ZJV - IDD .
ZJW ZJX - IAL .
ZKA ZKB - IBL .
ZKC ZKD - ICL .
ZKE ZKF - IDL .
ZKG ZKH - IAT .
ZKI ZKJ - IBT .
ZKK ZKL - ICT .
ZKM ZKN - IDT .
ZKO ZKP - IED .
ZKQ ZKR - IFD .
ZKS ZKT - IGD .
ZKU ZKV - IHD .
ZKW ZKX - OID .
ZLA ZLB - OKD .
ZLC ZLD - OLD .
ZLE ZLF - OHD .
ZLG ZLH - OAD .
ZLI ZLJ - OED .
ZLK ZLL - OCD .
ZLM ZLN - OGD .
ZLO ZLP - OAL .
ZLQ ZLR - OEL .
ZLS ZLT - OCL .
ZLU ZLV - OGL .
ZLW ZLX - *** .
       
ZMA ZMB - OBE .
ZMC ZMD - OFE .
ZME ZMF - OHE .
ZMG ZMH - OBM .
ZMI ZMJ - OFM .
ZMK ZML - ODM .
ZMM ZMN - OHM .
ZMO ZMP - IAE .
ZMQ ZMR - IBE .
ZMS ZMT - ICE .
ZMU ZMV - IDE .
ZMW ZMX - IAM .
ZNA ZNB - IBM .
ZNC ZND - ICM .
ZNE ZNF - IDM .
ZNG ZNH - IAU .
ZNI ZNJ - IBU .
ZNK ZNL - ICU .
ZNM ZNN - IDU .
ZNO ZNP - OMD .
ZNQ ZNR - IEE .
ZNS ZNT - IFE .
ZNU ZNV - IGE .
ZNW ZNX - IHE .
ZOA ZOB - OIE .
ZOC ZOD - OKE .
ZOE ZOF - OLE .
ZOG ZOH - ODE .
ZOI ZOJ - OAE .
ZOK ZOL - OEE .
ZOM ZON - OCE .
ZOO ZOP - OGE .
ZOQ ZOR - OAM .
ZOS ZOT - OEM .
ZOU ZOV - OCM .
ZOW ZOX - OGM .
       
ZPA ZPB - OBF .
ZPC ZPD - OFF .
ZPE ZPF - ODF .
ZPG ZPH - OHF .
ZPI ZPJ - OBN .
ZPK ZPL - OFN .
ZPM ZPN - ODN .
ZPO ZPP - OHN .
ZPQ ZPR - IAF .
ZPS ZPT - IBF .
ZPU ZPV - ICF .
ZPW ZPX - IDF .
ZQA ZQB - IAN .
ZQC ZQD - IBN .
ZQE ZQF - ICN .
ZQG ZQH - IDN .
ZQI ZQJ - OEN .
ZQK ZQL - IAV .
ZQM ZQN - IBV .
ZQO ZQP - ICV .
ZQQ ZQR - IDV .
ZQS ZQT - IEF .
ZQU ZQV - IFF .
ZQW ZQX - IGF .
ZRA ZRB - IHF .
ZRC ZRD - OIF .
ZRE ZRF - ONC .
ZRG ZRH - OOC .
ZRI ZRJ - OAF .
ZRK ZRL - OEF .
ZRM ZRN - OCF .
ZRO ZRP - OGF .
ZRQ ZRR - OAN .
ZRS ZRT - OCN .
ZRU ZRV - OGN .
ZRW ZRX - *** .
     
ZSA ZSB - OPA .
ZSC ZSD - OBG .
ZSE ZSF - OFG .
ZSG ZSH - ODG .
ZSI ZSJ - OHG .
ZSK ZSL - OBO .
ZSM ZSN - OFO .
ZSO ZSP - ODO .
ZSQ ZSR - OHO .
ZSS ZST - IAG .
ZSU ZSV - IBG .
ZSW ZSX - ICG .
ZTA ZTB - IDG .
ZTC ZTD - IAO .
ZTE ZTF - IBO .
ZTG ZTH - ICO .
ZTI ZTJ - IDO .
ZTK ZTL - IAW .
ZTM ZTN - IBW .
ZTO ZTP - ICW .
ZTQ ZTR - IDW .
ZTS ZTT - OJA .
ZTU ZTV - OIG .
ZTW ZTX - ONA .
ZUA ZUB - OOA .
ZUC ZUD - OAG .
ZUE ZUF - OEG .
ZUG ZUH - OCG .
ZUI ZUJ - OGG .
ZUK ZUL - OAO .
ZUM ZUN - OEO .
ZUO ZUP - OCO .
ZUQ ZUR - OGO .
ZUS ZUT - *** .
ZUU ZUV - *** .
ZUW ZUX - *** .
     
ZVA ZVB - OBH .
ZVC ZVD - OFH .
ZVE ZVF - ODH .
ZVG ZVH - OBP .
ZVI ZVJ - OFP .
ZVK ZVL - ODP .
ZVM ZVN - OHP .
ZVO ZVP - IAH .
ZVQ ZVR - IBH .
ZVS ZVT - ICH .
ZVU ZVV - IDH .
ZVW ZVX - IAP .
ZWA ZWB - IBP .
ZWC ZWD - ICP .
ZWE ZWF - IDP .
ZWG ZWH - IAX .
ZWI ZWJ - IBX .
ZWK ZWL - ICX .
ZWM ZWN - IDX .
ZWO ZWP - IIA .
ZWQ ZWR - OIH .
ZWS ZWT - ONB .
ZWU ZWV - OOB .
ZWW ZWX - OHH .
ZXA ZXB - OAH .
ZXC ZXD - OEH .
ZXE ZXF - OCH .
ZXG ZXH - OGH .
ZXI ZXJ - OAP .
ZXK ZXL - OEP .
ZXM ZXN - OCP .
ZXO ZXP - OGP .
ZXQ ZXR - IJA .
ZXS ZXT - *** .
ZXU ZXV - *** .
ZXW ZXX - *** . 

