*
* Connector Definitions
* Module: AR
* Description: Address Registers
* Revision:
* Date:
*
ZAA ZAB - IAA .
ZAC ZAD - IAB .
ZAE ZAF - IAC .
ZAG ZAH - IAD .
ZAI ZAJ - IAE .
ZAK ZAL - IAF .
ZAM ZAN - IAG .
ZAO ZAP - IAH .
ZAQ ZAR - IAI .
ZAS ZAT - IAJ .
ZAU ZAV - IAK .
ZAW ZAX - IAL .
ZBA ZBB - IAM .
ZBC ZBD - IAN .
ZBE ZBF - IAO .
ZBG ZBH - IAP .
ZBI ZBJ - IBA .
ZBK ZBL - IBB .
ZBM ZBN - IBC .
ZBO ZBP - IBD .
ZBQ ZBR - IBE .
ZBS ZBT - IBF .
ZBU ZBV - IBG .
ZBW ZBX - IBH .
ZCA ZCB - IBI .
ZCC ZCD - IBJ .
ZCE ZCF - IBK .
ZCG ZCH - IBL .
ZCI ZCJ - IBM .
ZCK ZCL - IBN .
ZCM ZCN - IBO .
ZCO ZCP - IBP .
ZCQ ZCR - ICA .
ZCS ZCT - ICB .
ZCU ZCV - ICC .
ZCW ZCX - ICD .
       	      
ZDA ZDB - ICE .
ZDC ZDD - ICF .
ZDE ZDF - ICG .
ZDG ZDH - ICH .
ZDI ZDJ - ICI .
ZDK ZDL - ICJ .
ZDM ZDN - ICK .
ZDO ZDP - ICL .
ZDQ ZDR - ICM .
ZDS ZDT - ICN .
ZDU ZDV - ICO .
ZDW ZDX - ICP .
ZEA ZEB - IDA .
ZEC ZED - IDB .
ZEE ZEF - IDC .
ZEG ZEH - IDD .
ZEI ZEJ - IDE .
ZEK ZEL - IDF .
ZEM ZEN - IDG .
ZEO ZEP - IDH .
ZEQ ZER - IDI .
ZES ZET - IDJ .
ZEU ZEV - IDK .
ZEW ZEX - IDL .
ZFA ZFB - IDM .
ZFC ZFD - IDN .
ZFE ZFF - IDO .
ZFG ZFH - IDP .
ZFI ZFJ - IEA .
ZFK ZFL - IEB .
ZFM ZFN - IEC .
ZFO ZFP - IED .
ZFQ ZFR - IEE .
ZFS ZFT - IEF .
ZFU ZFV - IEG .
ZFW ZFX - IEH .

ZGA ZGB - IEI .
ZGC ZGD - IEJ .
ZGE ZGF - IEK .
ZGG ZGH - IEL .
ZGI ZGJ - IEM .
ZGK ZGL - IEN .
ZGM ZGN - IEO .
ZGO ZGP - IEP .
ZGQ ZGR - IFA .
ZGS ZGT - IFB .
ZGU ZGV - IFC .
ZGW ZGX - IFD .
ZHA ZHB - IFE .
ZHC ZHD - IFF .
ZHE ZHF - IFG .
ZHG ZHH - IFH .
ZHI ZHJ - IFI .
ZHK ZHL - IFJ .
ZHM ZHN - IFK .
ZHO ZHP - IFL .
ZHQ ZHR - IFM .
ZHS ZHT - IFN .
ZHU ZHV - IFO .
ZHW ZHX - IFP .
ZIA ZIB - IGA .
ZIC ZID - IGB .
ZIE ZIF - IGC .
ZIG ZIH - IGD .
ZII ZIJ - IGE .
ZIK ZIL - IGF .
ZIM ZIN - IGG .
ZIO ZIP - IGH .
ZIQ ZIR - IGI .
ZIS ZIT - IGJ .
ZIU ZIV - IGK .
ZIW ZIX - IGL .
           
ZJA ZJB - IGN .
ZJC ZJD - IGO .
ZJE ZJF - IGP .
ZJG ZJH - IHA .
ZJI ZJJ - IHB .
ZJK ZJL - IHC .
ZJM ZJN - IHD .
ZJO ZJP - IHE .
ZJQ ZJR - IHF .
ZJS ZJT - IHG .
ZJU ZJV - IGM .
ZJW ZJX - IHH .
ZKA ZKB - IHI .
ZKC ZKD - IHJ .
ZKE ZKF - IHK .
ZKG ZKH - IHL .
ZKI ZKJ - IHM .
ZKK ZKL - IHN .
ZKM ZKN - IHO .
ZKO ZKP - IHP .
ZKQ ZKR - IIA .
ZKS ZKT - IIB .
ZKU ZKV - IIC .
ZKW ZKX - IJA .
ZLA ZLB - IJB .
ZLC ZLD - IJC .
ZLE ZLF - IJD .
ZLG ZLH - IJE .
ZLI ZLJ - IJF .
ZLK ZLL - IKA .
ZLM ZLN - IKB .
ZLO ZLP - ILA .
ZLQ ZLR - IMA .
ZLS ZLT - OAA .
ZLU ZLV - OAB .
ZLW ZLX - OAC .
          
ZMA ZMB - OAE .
ZMC ZMD - OAF .
ZME ZMF - OAG .
ZMG ZMH - OAH .
ZMI ZMJ - OAI .
ZMK ZML - OAJ .
ZMM ZMN - OAK .
ZMO ZMP - OAL .
ZMQ ZMR - OAM .
ZMS ZMT - OAN .
ZMU ZMV - OAO .
ZMW ZMX - OAP .
ZNA ZNB - OAD   .
ZNC ZND - OBA .
ZNE ZNF - OBB .
ZNG ZNH - OBC .
ZNI ZNJ - OBD .
ZNK ZNL - OBE .
ZNM ZNN - OBF .
ZNO ZNP - OBG .
ZNQ ZNR - OBH .
ZNS ZNT - OBI .
ZNU ZNV - OBJ .
ZNW ZNX - OBK .
ZOA ZOB - OBL .
ZOC ZOD - OBM .
ZOE ZOF - OBN .
ZOG ZOH - OBO .
ZOI ZOJ - OBP .
ZOK ZOL - OCA .
ZOM ZON - OCB .
ZOO ZOP - OCC .
ZOQ ZOR - OCD .
ZOS ZOT - OCE .
ZOU ZOV - OCF .
ZOW ZOX - OCG .

ZPA ZPB - OCI .
ZPC ZPD - OCJ .
ZPE ZPF - OCK .
ZPG ZPH - OCL .
ZPI ZPJ - OCM .
ZPK ZPL - OCN .
ZPM ZPN - OCO .
ZPO ZPP - OCP .
ZPQ ZPR - ODA .
ZPS ZPT - ODB .
ZPU ZPV - ODC .
ZPW ZPX - ODD .
ZQA ZQB - ODE .
ZQC ZQD - ODF .
ZQE ZQF - ODG .
ZQG ZQH - ODH .
ZQI ZQJ - OCH .
ZQK ZQL - ODI .
ZQM ZQN - ODJ .
ZQO ZQP - ODK .
ZQQ ZQR - ODL .
ZQS ZQT - ODM .
ZQU ZQV - ODN .
ZQW ZQX - ODO .
ZRA ZRB - ODP .
ZRC ZRD - OEA .
ZRE ZRF - OEB .
ZRG ZRH - OEC .
ZRI ZRJ - OED .
ZRK ZRL - OEE .
ZRM ZRN - OEF .
ZRO ZRP - OEG .
ZRQ ZRR - OEH .
ZRS ZRT - OEI .
ZRU ZRV - OEJ .
ZRW ZRX - OEK .
       
ZSA ZSB - OEM .
ZSC ZSD - OEN .
ZSE ZSF - OEO .
ZSG ZSH - OEP .
ZSI ZSJ - OFA .
ZSK ZSL - OFB .
ZSM ZSN - OFC .
ZSO ZSP - OFD .
ZSQ ZSR - OFE .
ZSS ZST - OFF .
ZSU ZSV - OFG .
ZSW ZSX - OFH .
ZTA ZTB - OFI .
ZTC ZTD - OFJ .
ZTE ZTF - OFK .
ZTG ZTH - OFL .
ZTI ZTJ - OFM .
ZTK ZTL - OEL .
ZTM ZTN - OFN .
ZTO ZTP - OFO .
ZTQ ZTR - OFP .
ZTS ZTT - OGA .
ZTU ZTV - OGB .
ZTW ZTX - OGC .
ZUA ZUB - OGD .
ZUC ZUD - OGE .
ZUE ZUF - OGF .
ZUG ZUH - OGG .
ZUI ZUJ - OGH .
ZUK ZUL - OGI .
ZUM ZUN - OGJ .
ZUO ZUP - OGK .
ZUQ ZUR - OGL .
ZUS ZUT - OGM .
ZUU ZUV - OGN .
ZUW ZUX - OGO .
       
ZVA ZVB - OHA .
ZVC ZVD - OHB .
ZVE ZVF - OHC .
ZVG ZVH - OHD .
ZVI ZVJ - OHE .
ZVK ZVL - OHF .
ZVM ZVN - OHG .
ZVO ZVP - OHH .
ZVQ ZVR - OHI .
ZVS ZVT - OHJ .
ZVU ZVV - OHK .
ZVW ZVX - OHL .
ZWA ZWB - OHM .
ZWC ZWD - OHN .
ZWE ZWF - OHO .
ZWG ZWH - OHP .
ZWI ZWJ - OIA .
ZWK ZWL - OGP .
ZWM ZWN - OIB .
ZWO ZWP - OIC .
ZWQ ZWR - OID .
ZWS ZWT - OIE .
ZWU ZWV - OIF .
ZWW ZWX - OIG .
ZXA ZXB - OIH .
ZXC ZXD - OIJ .
ZXE ZXF - OKA .
ZXG ZXH - OKB .
ZXI ZXJ - OMA .
ZXK ZXL - OMB .
ZXM ZXN - OMC .
ZXO ZXP - OMD .
ZXQ ZXR - OME .
ZXS ZXT - OMF .
ZXU ZXV - OMG .
ZXW ZXX - OMH .

