*
* Package Definitions
* Module: GB
* Description: Scalar Integer Shift
* Revision:
* Date:
*  
B1L - TAA TBA TCA TDA .
B4B - GGA GGI GGQ .
B5P - eca ecb .
B7X - FJA FTA .
B8B - GHA GHI GHQ .
BCX - FBA FLA .
BDB - GAA .
BEX - FAA .
BGX - FCA FMA .
BHB - GBA GBI GBQ .
BJB - GIA GII .
BKX - FDA FNA .
BLB - GCA GCI GCQ .
BNX - FEA FOA .
BOX - FFA FPA .
BPB - GDA GDI GDQ .
BRX - FGA FQA .
BSX - FHA FRA .
BTB - GEA GEI GEQ .
BVX - FIA .
BWX - FSA .
BXB - GFA GFI GFQ .
C1L - TEI TFI TGI THI .
C2X - OGA .
C3X - OCA .
C4J - JCA .
C5X - EAA .
C6X - OHA .
C7P - DHA DHB .
CAL - TEA TFA TGA THA .
CBX - OAA .
CCP - DAA DAB .
CDL - ORA ORB .
CFX - OBA .
CGP - DBA DBB .
CIJ - tqa tqb tqc tqd .
CJP - DGA DGB .
CKP - DCA DCB .
CLL - ORC ORD .
CML - TEQ TFQ TGQ THQ .
CNX - ODA .
COP - DDA DDB .
CPM - AAA OKA .
CQL - TIA TJA TKA TLA .
CRX - OEA .
CSP - DEA DEB .
CTI - wad .
CUJ - tqe tqf tqg tqh .
CVX - OFA .
CWP - DFA DFB .
CXL - CAA CBA CCA CDA .
E1L - TAB TBB TCB TDB .
E4B - GGB GGJ GGR .
E5P - ecc ecd .
E7X - FJB FTB .
E8B - GHB GHJ GHR .
ECX - FBB FLB .
EDB - GAB .
EEX - FAB .
EGX - FCB FMB .
EHB - GBB GBJ GBR .
EJB - GIB GIJ .
EKX - FDB FNB .
ELB - GCB GCJ GCR .
ENX - FEB FOB .
EOX - FFB FPB .
EPB - GDB GDJ GDR .
ERX - FGB FQB .
ESX - FHB FRB .
ETB - GEB GEJ GER .
EWX - FIB FSB .
EXB - GFB GFJ GFR .
F1L - TEJ TFJ TGJ THJ .
F2X - OGB .
F3X - OCB .
F4J - JBB JCB .
F5X - EAB .
F6X - OHB .
F7P - DHC DHD .
FAL - TEB TFB TGB THB .
FBX - OAB .
FCP - DAC DAD .
FDL - ORE ORF .
FFX - OBB .
FGP - DBC DBD .
FHI - waf .
FIJ - tra trb trc trd .
FJP - DGC DGD .
FKP - DCC DCD .
FLL - ORG ORH .
FML - TER TFR TGR THR .
FNX - ODB .
FOP - DDC DDD .
FPM - AAB OKB .
FQL - TIB TJB TKB TLB .
FRX - OEB .
FSP - DEC DED .
FTJ - wab wac wae .
FUJ - tre trf trg trh .
FVX - OFB .
FWP - DFC DFD .
FXL - CAB CBB CCB CDB .
H1L - TAC TBC TCC TDC .
H4B - GGK .
H5M - eba ebe ebi .
H7X - FJC FTC .
H8B - GHC GHK .
HCX - FBC FLC .
HDB - GAC .
HEX - FAC .
HGX - FCC FMC .
HHB - GBC GBK .
HIB - GCP .
HJB - GIC .
HKX - FDC FNC .
HLB - GCC GCK .
HNX - FEC FOC .
HOX - FFC FPC .
HPB - GDC GDK .
HQB - GGC .
HRX - FGC FQC .
HSX - FHC FRC .
HTB - GEC GEK GES .
HWX - FIC FSC .
HXB - GFC GFK .
I1L - TEK TFK TGK THK .
I2X - OGC .
I3X - OCC .
I4J - JBC .
I5X - EAC .
I6X - OHC .
I7P - DHE DHF .
IAL - TEC TFC TGC THC .
IBX - OAC .
ICP - DIA DIB .
IDL - ORI ORJ .
IEJ - JCC .
IFX - OBC .
IGP - DJA DJB .
IIJ - tsa tsb tsc tsd .
IKP - DKA DKB .
ILL - ORK ORL .
IML - TES TFS TGS THS .
INX - ODC .
IOP - DDE DDF .
IPM - AAC OKC .
IQL - TIC TJC TKC TLC .
IRX - OEC .
ISP - DMA DMB .
ITX - XAA .
IUJ - tse tsf tsg tsh .
IVX - OFC .
IWP - DNA DNB .
IXL - CAC CBC CCC CDC .
K1L - TAD TBD TCD TDD .
K4B - GGD GGL .
K5M - ebb ebf ebj .
K7X - FTD .
K8B - GHD GHL .
KCX - FBD FLD .
KDB - GAD GAL .
KEX - FAD .
KGX - FCD .
KHB - GBD .
KKX - FDD FND .
KLB - GCD GCL .
KNX - FED FOD .
KOX - FFD FPD .
KPB - GDD GDL .
KRX - FGD FQD .
KSX - FHD FRD .
KTB - GED GEL GET .
KWX - FID FSD .
KXB - GFD GFL .
L1L - TEL TFL TGL THL .
L2X - OGD .
L3X - OCD .
L4J - JCD .
L5X - EAD .
L6X - OHD .
LAL - TED TFD TGD THD .
LBX - OAD .
LCP - DIC DID .
LDL - ORM ORN .
LEL - TID TJD TKD TLD .
LFX - OBD .
LGP - DJC DJD .
LHP - DIE DIF .
LIJ - tta ttb ttc ttd .
LJP - DIG DIH .
LKP - DCE DCF .
LLL - ORO ORP .
LML - TET TFT TGT THT .
LNX - ODD .
LOP - DLA DLB .
LPM - AAD OKD .
LQJ - JBD .
LRX - OED .
LSP - DMC DMD .
LTP - DFE DFF .
LUJ - tte ttf ttg tth .
LVX - OFD .
LXL - CAD CBD CCD CDD .
MCX - FBH .
MWX - FSE .
N1L - TAE TBE TCE TDE .
N4B - GGE GGM .
N5M - ebc ebg ebk .
N7X - FTE .
N8B - GHE GHM .
NCX - FBE FLE .
NDB - GAE GAM .
NEX - FAE .
NGX - FCE FME .
NHB - GBE GBM .
NKX - FDE FNE .
NLB - GCE GCM .
NMX - FIE .
NNX - FEE FOE .
NOX - FFE FPE .
NPB - GDE GDM .
NRX - FGE FQE .
NSX - FHE FRE .
NTB - GEE GEM GEU .
NXB - GFE GFM .
O1L - TEM TFM TGM THM .
O2X - OGE .
O3X - OCE .
O4J - JBE JCE .
O5X - EAE .
O6X - OHE .
O7P - DHG DHH .
OAL - TEE TFE TGE THE .
OBX - OAE .
OCP - DAE DAF .
OFX - OBE .
OGP - DBE DBF .
OIJ - TMA TMB TMC TMD .
OJP - DGE DGF .
OKP - DKC DKD .
OML - TEU TFU TGU THU .
ONX - ODE .
OOP - DLC DLD .
OPM - AAE OKE .
OQL - TIE TJE TKE TLE .
ORX - OEE .
OSP - DEE DEF .
OTX - QFA QFB .
OUJ - TME TMF TMG TMH .
OVX - OFE .
OWP - DNC DND .
OXL - CAE CBE CCE CDE .
Q1L - TAF TBF TCF TDF .
Q4B - GGF GGN .
Q5M - ebd ebh ebl .
Q7X - FTF .
Q8B - GHF GHN .
QCX - FBF FLF .
QDB - GAF GAN .
QEX - FAF .
QGX - FCF FMF .
QHB - GBF GBN .
QKX - FDF FNF .
QLB - GCF GCN .
QMX - FIF .
QNX - FEF FOF .
QOX - FFF FPF .
QPB - GDF GDN .
QRX - FGF FQF .
QSX - FHF FRF .
QTB - GEF GEN GEV .
QWX - FSF .
QXB - GFF GFN .
R1L - TEN TFN TGN THN .
R2X - OGF .
R3X - OCF .
R4P - DOA DOB .
R5X - EAF .
R6X - OHF .
R7P - DPE DPF .
RAL - TEF TFF TGF THF .
RBX - OAF .
RCP - DPG .
RDL - TIF TJF TKF TLF .
REJ - TNC .
RFX - OBF .
RGP - DBG DBH .
RIJ - TNA TNB TND .
RJP - DGG DGH .
RKP - DCG DCH .
RML - TEV TFV TGV THV .
RNX - ODF .
ROP - DLE DLF .
RPM - AAF OKF .
RQJ - JBF JCF .
RRX - OEF .
RSP - DME DMF .
RTX - QFC QFD .
RUJ - TNE TNF TNG TNH .
RVX - OFF .
RWP - DNE DNF .
RXL - CAF CBF CCF CDF .
T1L - TAG TBG TCG TDG .
T3P - DPA DPB .
T4B - GGG GGO .
T5I - JEA JEB JGA .
T6P - DPC DPD .
T7X - FTG .
T8B - GHG GHO .
TCX - FBG FLG .
TDB - GAG GAO .
TEX - FAG .
TGX - FCG FMG .
THB - GBG GBO .
TIX - FSG .
TJL - qed .
TKX - FDG FNG .
TLB - GCG GCO .
TNX - FEG FOG .
TOX - FFG FPG .
TPB - GDG GDO .
TRX - FGG FQG .
TSX - FHG FRG .
TTB - GEG GEO GEW .
TWX - FIG .
TXB - GFG GFO .
U1L - TEO TFO TGO THO .
U2X - OGG .
U3X - OCG .
U4J - JAA JAB JAC JAD .
U6X - OHG .
U7P - DOC DOD .
UAL - TEG TFG TGG THG .
UBX - OAG .
UCP - DAG DAH .
UFX - OBG .
UGP - DJE DJF .
UHL - qec .
UIJ - TOA TOB TOC TOD .
UJP - DOG DOH .
UKP - DKE DKF .
ULP - qea qeb .
UML - TEW TFW TGW THW .
UNX - ODG .
UOP - DDG DDH .
UPM - AAG OKG .
UQL - TIG TJG TKG TLG .
URX - OEG .
USP - DEG DEH .
UTX - QFE QFF .
UUJ - TOE TOF TOG TOH .
UVX - OFG .
UWP - DFG DFH .
UXH - jda .
VKX - FNH .
W1L - TAH TBH TCH TDH .
W4B - GGH .
W5I - JEC JED .
W8B - GHH GHP .
WCX - FLH .
WDB - GAH GAP .
WEX - FAH .
WGX - FCH FMH .
WHB - GBH GBP .
WKX - FDH .
WLB - GCH .
WMX - FIH .
WNX - FEH FOH .
WOX - FFH FPH .
WPB - GDH GDP .
WQB - GGP .
WRX - FGH FQH .
WSX - FHH FRH .
WTB - GEH GEP GEX .
WWX - FSH .
WXB - GFH GFP .
X1L - TEP TFP TGP THP .
X2X - OGH .
X3X - OCH .
X4J - JAE JAF .
X5B - GBL .
X6X - OHH .
X7P - DOE DOF .
X8L - QCA QCB QCC QCD .
XAL - TEH TFH TGH THH .
XBX - OAH .
XDP - OKH QGA .
XEP - DJG DJH .
XFX - OBH .
XGX - FMD .
XHL - AAH AAI AAJ .
XIJ - TPA TPB TPC TPD .
XKP - DKG DKH .
XLL - QBA QDA .
XML - TEX TFX TGX THX .
XNX - ODH .
XOP - DLG DLH .
XPL - QDB QDC QDD .
XQL - TIH TJH TKH TLH .
XRX - OEH .
XSP - DMG DMH .
XTX - QFG QFH .
XUJ - TPE TPF TPG TPH .
XVX - OFH .
XWP - DNG DNH .
XXL - QBB QBC QBD QBE . 
