*
* Connector Definitions
* Module: TB
* Description: Memory interface modules, packetize address and data, SECDED
* Revision:
* Date: 
*
ZAA ZAB - OCA .
ZAC ZAD - ODA .
ZAE ZAF - ODI .
ZAG ZAH - ODQ .
ZAI ZAJ - IAA .
ZAK ZAL - IEA .
ZAM ZAN - IAI .
ZAO ZAP - IEI .
ZAQ ZAR - IBA .
ZAS ZAT - IFA .
ZAU ZAV - IBI .
ZAW ZAX - IFI .
ZBA ZBB - OCI .
ZBC ZBD - OCQ .
ZBE ZBF - ICA .
ZBG ZBH - IGA .
ZBI ZBJ - ICI .
ZBK ZBL - IGI .
ZBM ZBN - IKD .
ZBO ZBP - IDA .
ZBQ ZBR - IHA .
ZBS ZBT - IDI .
ZBU ZBV - IHI .
ZBW ZBX - IJA .
ZCA ZCB - OAA .
ZCC ZCD - OAI .
ZCE ZCF - OAQ .
ZCG ZCH - IIA .
ZCI ZCJ - IIB .
ZCK ZCL - IIC .
ZCM ZCN - IID .
ZCO ZCP - OFA .
ZCQ ZCR - OBA .
ZCS ZCT - OBI .
ZCU ZCV - OBQ .
ZCW ZCX - *** .
       	 
ZDA ZDB - OCB .
ZDC ZDD - ODB .
ZDE ZDF - ODJ .
ZDG ZDH - ODR .
ZDI ZDJ - IAB .
ZDK ZDL - IEB .
ZDM ZDN - IAJ .
ZDO ZDP - IEJ .
ZDQ ZDR - IBB .
ZDS ZDT - IFB .
ZDU ZDV - IBJ .
ZDW ZDX - IFJ .
ZEA ZEB - OCJ .
ZEC ZED - OCR .
ZEE ZEF - ICB .
ZEG ZEH - IGB .
ZEI ZEJ - ICJ .
ZEK ZEL - IGJ .
ZEM ZEN - IDB .
ZEO ZEP - IHB .
ZEQ ZER - IDJ .
ZES ZET - IHJ .
ZEU ZEV - IJB .
ZEW ZEX - OAB .
ZFA ZFB - OAR .
ZFC ZFD - OAJ .
ZFE ZFF - IIE .
ZFG ZFH - IIF .
ZFI ZFJ - IIG .
ZFK ZFL - IIH .
ZFM ZFN - OFB .
ZFO ZFP - OBB .
ZFQ ZFR - OBJ .
ZFS ZFT - OBR .
ZFU ZFV - *** .
ZFW ZFX - *** .
       
ZGA ZGB - OCC .
ZGC ZGD - ODC .
ZGE ZGF - ODK .
ZGG ZGH - ODS .
ZGI ZGJ - IAC .
ZGK ZGL - IEC .
ZGM ZGN - IAK .
ZGO ZGP - IEK .
ZGQ ZGR - IBC .
ZGS ZGT - IFC .
ZGU ZGV - IBK .
ZGW ZGX - IFK .
ZHA ZHB - OCK .
ZHC ZHD - OCS .
ZHE ZHF - ICC .
ZHG ZHH - IGC .
ZHI ZHJ - ICK .
ZHK ZHL - IGK .
ZHM ZHN - IDC .
ZHO ZHP - IHC .
ZHQ ZHR - IDK .
ZHS ZHT - IHK .
ZHU ZHV - IJC .
ZHW ZHX - OAC .
ZIA ZIB - OAK .
ZIC ZID - OAS .
ZIE ZIF - III .
ZIG ZIH - IIJ .
ZII ZIJ - IIK .
ZIK ZIL - IIL .
ZIM ZIN - OFC .
ZIO ZIP - OBC .
ZIQ ZIR - OBK .
ZIS ZIT - OBS .
ZIU ZIV - *** .
ZIW ZIX - *** .
       
ZJA ZJB - OCD .
ZJC ZJD - ODD .
ZJE ZJF - ODL .
ZJG ZJH - ODT .
ZJI ZJJ - IAD .
ZJK ZJL - IED .
ZJM ZJN - IAL .
ZJO ZJP - IEL .
ZJQ ZJR - IBD .
ZJS ZJT - IFD .
ZJU ZJV - IBL .
ZJW ZJX - IFL .
ZKA ZKB - OCL .
ZKC ZKD - OCT .
ZKE ZKF - ICD .
ZKG ZKH - IGD .
ZKI ZKJ - ICL .
ZKK ZKL - IGL .
ZKM ZKN - IDD .
ZKO ZKP - IHD .
ZKQ ZKR - IDL .
ZKS ZKT - IHL .
ZKU ZKV - IJD .
ZKW ZKX - OAD .
ZLA ZLB - OAL .
ZLC ZLD - OAT .
ZLE ZLF - IIM .
ZLG ZLH - IIN .
ZLI ZLJ - IIO .
ZLK ZLL - IIP .
ZLM ZLN - OFD .
ZLO ZLP - OBD .
ZLQ ZLR - OBL .
ZLS ZLT - OBT .
ZLU ZLV - *** .
ZLW ZLX - *** .
       
ZMA ZMB - OCE .
ZMC ZMD - ODE .
ZME ZMF - ODM .
ZMG ZMH - ODU .
ZMI ZMJ - IAE .
ZMK ZML - IEE .
ZMM ZMN - IAM .
ZMO ZMP - IEM .
ZMQ ZMR - IBE .
ZMS ZMT - IFE .
ZMU ZMV - IBM .
ZMW ZMX - IFM .
ZNA ZNB - OCM .
ZNC ZND - OCU .
ZNE ZNF - ICE .
ZNG ZNH - IGE .
ZNI ZNJ - ICM .
ZNK ZNL - IGM .
ZNM ZNN - IKA .
ZNO ZNP - IKB .
ZNQ ZNR - IDE .
ZNS ZNT - IHE .
ZNU ZNV - IDM .
ZNW ZNX - IHM .
ZOA ZOB - IKC .
ZOC ZOD - OAE .
ZOE ZOF - OAM .
ZOG ZOH - OAU .
ZOI ZOJ - IIQ .
ZOK ZOL - IIR .
ZOM ZON - IIS .
ZOO ZOP - IIT .
ZOQ ZOR - OFE .
ZOS ZOT - OBE .
ZOU ZOV - OBM .
ZOW ZOX - OBU .
       
ZPA ZPB - OCF .
ZPC ZPD - ODF .
ZPE ZPF - ODN .
ZPG ZPH - ODV .
ZPI ZPJ - IAF .
ZPK ZPL - IEF .
ZPM ZPN - IAN .
ZPO ZPP - IEN .
ZPQ ZPR - IBF .
ZPS ZPT - IFF .
ZPU ZPV - IBN .
ZPW ZPX - IFN .
ZQA ZQB - OCN .
ZQC ZQD - OCV .
ZQE ZQF - ICF .
ZQG ZQH - IGF .
ZQI ZQJ - ICN .
ZQK ZQL - IGN .
ZQM ZQN - IDF .
ZQO ZQP - IHF .
ZQQ ZQR - IDN .
ZQS ZQT - IHN .
ZQU ZQV - OAF .
ZQW ZQX - OAN .
ZRA ZRB - OAV .
ZRC ZRD - IJH .
ZRE ZRF - IJE .
ZRG ZRH - IJF .
ZRI ZRJ - IJG .
ZRK ZRL - OBF .
ZRM ZRN - OBN .
ZRO ZRP - OBV .
ZRQ ZRR - *** .
ZRS ZRT - *** .
ZRU ZRV - *** .
ZRW ZRX - *** .
     
ZSA ZSB - OCG .
ZSC ZSD - ODG .
ZSE ZSF - ODW .
ZSG ZSH - IAG .
ZSI ZSJ - IEG .
ZSK ZSL - IAO .
ZSM ZSN - IEO .
ZSO ZSP - IBG .
ZSQ ZSR - IFG .
ZSS ZST - IBO .
ZSU ZSV - IFO .
ZSW ZSX - OCO .
ZTA ZTB - ODO .
ZTC ZTD - OCW .
ZTE ZTF - ICG .
ZTG ZTH - IGG .
ZTI ZTJ - ICO .
ZTK ZTL - IGO .
ZTM ZTN - IDG .
ZTO ZTP - IHG .
ZTQ ZTR - IDO .
ZTS ZTT - IHO .
ZTU ZTV - OAG .
ZTW ZTX - OAO .
ZUA ZUB - OAW .
ZUC ZUD - IJL .
ZUE ZUF - IJI .
ZUG ZUH - IJJ .
ZUI ZUJ - IJK .
ZUK ZUL - OBG .
ZUM ZUN - OBO .
ZUO ZUP - OBW .
ZUQ ZUR - *** .
ZUS ZUT - *** .
ZUU ZUV - *** .
ZUW ZUX - *** .
     
ZVA ZVB - OCH .
ZVC ZVD - ODH .
ZVE ZVF - ODP .
ZVG ZVH - ODX .
ZVI ZVJ - IAH .
ZVK ZVL - IEH .
ZVM ZVN - IAP .
ZVO ZVP - IEP .
ZVQ ZVR - IBH .
ZVS ZVT - IFH .
ZVU ZVV - IBP .
ZVW ZVX - IFP .
ZWA ZWB - OCP .
ZWC ZWD - OCX .
ZWE ZWF - ICH .
ZWG ZWH - IGH .
ZWI ZWJ - ICP .
ZWK ZWL - IGP .
ZWM ZWN - IDH .
ZWO ZWP - IHH .
ZWQ ZWR - IDP .
ZWS ZWT - IHP .
ZWU ZWV - OAH .
ZWW ZWX - OAP .
ZXA ZXB - OAX .
ZXC ZXD - IJP .
ZXE ZXF - IJM .
ZXG ZXH - IJN .
ZXI ZXJ - IJO .
ZXK ZXL - OBH .
ZXM ZXN - OBP .
ZXO ZXP - OBX .
ZXQ ZXR - *** .
ZXS ZXT - *** .
ZXU ZXV - *** .
ZXW ZXX - *** .    

