*
* Package Definitions
* Module: TB
* Description: Memory interface modules, packetize address and data, SECDED
* Revision:
* Date: 
*
A4L - BEF BEG .
AAL - KAA KAI .
ACL - JAA FAA GAA HAA .
ADL - JAI FAI GAI HAI .
AEL - KBA KBI .
AGL - JBA FBA GBA HBA .
AHL - JBI FBI GBI HBI .
AIL - KCA KCI .
AJT - BEE .
AKL - JCA FCA GCA HCA .
ALL - JCI FCI GCI HCI .
AML - KDA KDI .
AOL - JDA FDA GDA HDA .
APL - JDI FDI GDI HDI .
AST - BEA .
ATT - BEB .
AWM - BEC .
AXT - BED .
B1M - CEC .
B3T - DEB *** DEC .
B4L - TGA TGC TGE .
B5M - CED .
B7T - EEA .
B8L - THA THC THE .
BCL - EAA BAA CAA DAA .
BDL - EAI BAI CAI DAI .
BGL - EBA BBA CBA DBA .
BHL - EBI BBI CBI .
BKL - ECA BCA CCA DCA .
BLL - ECI BCI CCI DCI .
BOL - EDA BDA CDA DDA .
BPL - EDI BDI CDI DDI .
BQM - CEA .
BRT - CEE .
BTL - TEA TEC TEE .
BUM - CEB .
BWT - DEA .
BXL - TFA TFC TFE .
C1L - TGB TGD TGF .
C2M - OCA .
C5L - THB THD THF .
C6M - ODA .
C7P - ODI ODQ .
CBP - LAA LAI .
CCP - AAA AAI .
CFP - LBA LBI .
CGP - ABA ABI .
CIP - LCA LCI .
CJP - OCI OCQ .
CKP - ACA ACI .
CML - QBD QBA QBB QBC .
CNP - LDA LDI .
COP - ADA ADI .
CPL - oea .
CQL - TEB TED TEF .
CRM - OAA .
CSP - OAI OAQ .
CTX - OFA .
CUL - TFB TFD TFF .
CVM - OBA .
CWP - OBI OBQ .
D4L - BFF BFG .
DAL - KAB KAJ .
DCL - JAB FAB GAB HAB .
DDL - JAJ FAJ GAJ HAJ .
DEL - KBB KBJ .
DGL - JBB FBB GBB HBB .
DHL - JBJ FBJ GBJ HBJ .
DIL - KCB KCJ .
DJT - BFE .
DKL - JCB FCB GCB HCB .
DLL - JCJ FCJ GCJ HCJ .
DML - KDB KDJ .
DOL - JDB FDB GDB HDB .
DPL - JDJ FDJ GDJ HDJ .
DST - BFA .
DTT - BFB .
DWM - BFC .
DXT - BFD .
E1M - CFC .
E3T - DFB *** DFC .
E5M - CFD .
E7T - EEB .
ECL - EAB BAB CAB DAB .
EDL - EAJ BAJ CAJ DAJ .
EGL - EBB BBB CBB DBB .
EHL - EBJ BBJ CBJ DBJ .
EKL - ECB BCB CCB DCB .
ELL - ECJ BCJ CCJ DCJ .
EOL - EDB BDB CDB DDB .
EPL - EDJ BDJ CDJ DDJ .
EQM - CFA .
ERT - CFE .
EUM - CFB .
EWT - DFA .
F2M - OCB .
F6M - ODB .
F7P - ODJ ODR .
FBP - LAB LAJ .
FCP - AAB AAJ .
FFP - LBB LBJ .
FGP - ABB ABJ .
FIP - LCB LCJ .
FJP - OCJ OCR .
FKP - ACB ACJ .
FNP - LDB LDJ .
FOP - ADB ADJ .
FPL - oeb .
FRM - OAB .
FSP - OAR OAJ .
FTX - OFB .
FVM - OBB .
FWP - OBJ OBR .
G4L - BGF BGG .
GAL - KAC KAK .
GCL - JAC FAC GAC HAC .
GDL - JAK FAK KBC GAK  .
GEL - KBK HAK .
GGL - JBC FBC GBC HBC .
GHL - JBK FBK GBK HBK .
GIL - KCC KCK .
GJT - BGE .
GKL - JCC FCC GCC HCC .
GLL - JCK FCK GCK HCK .
GML - KDC KDK .
GOL - JDC FDC GDC HDC .
GPL - JDK FDK GDK HDK .
GST - BGA .
GTT - BGB .
GWM - BGC .
GXT - BGD .
H1M - CGC .
H3T - DGB .
H5M - CGD .
H7T - EEC .
HCL - EAC BAC CAC DAC .
HDL - EAK BAK BAP CAK  .
HGL - EBC BBC CBC CBH  .
HHL - EBK BBK CBK CBP  .
HKL - ECC CCC DCC DAK .
HLL - ECK BCK CCK DCK  .
HML - DBC DBK DCP .
HOL - EDC BDC CDC DDC .
HPL - EDK BDK CDK DDK .
HQM - CGA .
HRT - CGE .
HUM - CGB .
HWT - DGA .
HXL - BCC .
I2M - OCC .
I6M - ODC .
I7P - ODK ODS .
IBP - LAC LAK .
ICP - AAC AAK .
IDL - JAO .
IFP - LBC LBK .
IGP - ABC ABK .
IIP - LCC LCK . 
IJP - OCK OCS .
IKP - ACC ACK .
ILL - JCO .
INP - LDC LDK .
IOP - ADC ADK .
IPL - oec .
IRM - OAC .
ISP - OAK OAS .
ITX - OFC .
IVM - OBC .
IWP - OBK OBS .
J3T - BHE .
J4L - BHF BHG .
JAL - KAD KAL .
JCL - JAD FAD GAD HAD .
JDL - JAL FAL GAL HAL .
JEL - KBD KBL .
JGL - JBD FBD GBD HBD .
JHL - JBL FBL GBL HBL .
JIL - KCD KCL .
JKL - JCD FCD GCD HCD .
JLL - JCL FCL GCL HCL .
JML - KDD KDL .
JOL - JDD FDD GDD HDD .
JPL - JDL FDL GDL HDL .
JST - BHA .
JTT - BHB .
JWM - BHC .
JXT - BHD .
K1M - CHC .
K3T - DHB .
K5M - CHD .
K7T - EED .
KCL - EAD BAD CAD DAD .
KDL - EAL BAL CAL DAL .
KGL - EBD BBD CBD DBD .
KHL - EBL BBL CBL DBL .
KKL - ECD BCD CCD DCD .
KLL - ECL BCL CCL DCL .
KOL - EDD BDD CDD DDD .
KPL - EDL BDL CDL DDL .
KQM - CHA .
KRT - CHE .
KUM - CHB .
KWT - DHA .
L2M - OCD .
L6M - ODD .
L7P - ODL ODT .
LBP - LAD LAL .
LCP - AAD AAL .
LFP - LBD LBL .
LGP - ABD ABL .
LIP - LCD LCL .
LJP - OCL OCT .
LKP - ACD ACL .
LNP - LDD LDL .
LOP - ADD ADL .
LPL - oed .
LRM - OAD .
LSP - OAL OAT .
LTX - OFD .
LVM - OBD .
LWP - OBL OBT .
M4L - BIG .
MAL - KAE KAM .
MCL - JAE FAE GAE DAH  .
MDL - JAM FAM GAM HAM .
MEL - KBE KBM .
MFL - HAE DBP HBM  .
MGL - JBE FBE GBE HBE .
MHL - EBM JBM FBM GBM  .
MIL - KCE KCM .
MJT - BIE .
MKL - ECE JCE FCE GCE  .
MLL - JCM FCM GCM HCM .
MML - KDE KDM .
MNL - HCE HDM .
MOL - JDE FDE GDE HDE .
MPL - EDP JDM FDM GDM  .
MQL - BIF .
MST - BIA .
MTT - BIB .
MWM - BIC .
MXT - BID .
N1M - CIC .
N3T - DIB .
N5M - CID .
N7T - EEE .
NCL - EAE BAE CAE DAE .
NDL - EAM BAM CAM DAM .
NGL - EBE BBE CBE DBE .
NHL - BBM CBM DBM .
NKL - BCE CCE DCE .
NLL - ECM BCM CCM DCM .
NOL - EDE BDE CDE DDE .
NPL - EDM BDM CDM DDM .
NQM - CIA .
NRT - CIE .
NUM - CIB .
NWT - DIA .
O1L - TDC TAC TBC TCC .
O2M - OCE .
O6M - ODE .
O7P - ODM ODU .
OAL - TDA TAA TBA TCA .
OBP - LAE LAM .
OCP - AAE AAM .
OEL - TDB TAB TBB TCB .
OFP - LBE LBM .
OGP - ABE ABM .
OIP - LCE LCM .
OJP - OCM OCU .
OKP - ACE ACM .
OLP - QAA QAB .
OML - TDD TAD TBD TCD .
ONP - LDE LDM .
OOP - ADE ADM .
OPP - QAC QAD .
ORM - OAE .
OSP - OAM OAU .
OTX - OFE .
OVM - OBE .
OWP - OBM OBU .
P4L - BJF BJG .
PAL - KAF KAN .
PCL - JAF FAF GAF HAF .
PDL - JAN FAN GAN HAN .
PEL - KBF KCF KBN .
PGL - JBF FBF GBF HBF .
PHL - JBN FBN GBN HBN .
PIL - KCN .
PJT - BJE .
PKL - JCF FCF GCF HCF .
PLL - JCN FCN GCN HCN .
PML - KDF KDN .
POL - JDF FDF GDF HDF .
PPL - JDN FDN GDN HDN .
PST - BJA .
PTT - BJB .
PWM - BJC .
PXT - BJD .
Q1M - CJC .
Q5M - CJD .
Q7T - EEF .
QCL - EAF BAF CAF DAF .
QDL - EAN BAN CAN DAN .
QGL - EBF BBF CBF DBF .
QHL - EBN BBN CBN DBI .
QIL - DBN .
QJT - DJB .
QKL - ECF BCF CCF DCF .
QLL - ECN BCN CCN DCN .
QOL - EDF BDF CDF DDF .
QPL - EDN BDN CDN DDN .
QQM - CJA .
QRT - CJE .
QUM - CJB .
QWT - DJA .
R2M - OCF .
R6M - ODF .
R7P - ODN ODV .
RBP - LAF LAN .
RCP - AAF AAN .
RFP - LBF LBN .
RGP - ABF ABN .
RIP - LCF LCN .
RJP - OCN OCV .
RKP - ACF ACN .
RMP - LDN .
RNP - LDF .
ROP - ADF ADN .
RRM - OAF .
RSP - OAN OAV .
RTL - oeh oee oef oeg .
RVM - OBF .
RWP - OBN OBV .
S3T - BKE .
S4L - BKF BKG .
SAL - KAG KAO .
SCL - JAG FAG GAG HAG .
SDL - FAO GAO HAO .
SEL - KBG KBO .
SGL - JBG FBG GBG HBG .
SHL - JBO FBO GBO HBO .
SIL - KCG KCO .
SKL - JCG FCG GCG HCG .
SLL - FCO GCO HCO .
SML - KDG KDO .
SOL - JDG FDG GDG HDG .
SPL - JDO FDO GDO HDO .
SST - BKA .
STT - BKB .
SWM - BKC .
SXT - BKD .
T1M - CKC .
T5M - CKD .
T7T - EEG .
TCL - EAG BAG CAG DAG .
TDL - EAO BAO CAO DAO .
TGL - EBG BBG CBG DBG .
THL - EBO BBO CBO DBO .
TJT - DKB *** DKC .
TKL - ECG BCG CCG DCG .
TLL - ECO BCO CCO DCO .
TOL - EDG BDG CDG DDG .
TPL - EDO BDO CDO DDO .
TQM - CKA .
TRT - CKE .
TUM - CKB .
TWT - DKA .
U2M - OCG .
U6M - ODG .
U7P - ODW .
UBP - LAG LAO .
UCP - AAG AAO .
UFP - LBG LBO .
UGP - ABG ABO .
UHP - ODO .
UIP - OCO OCW .
UJP - LCG LCO .
UKP - ACG ACO .
UMP - LDO .
UNP - LDG .
UOP - ADG ADO .
URM - OAG .
USP - OAO OAW .
UTL - oel oei oej oek .
UVM - OBG .
UWP - OBO OBW .
V3T - BLE .
V4L - BLF BLG .
VAL - KAH KAP .
VCL - JAH FAH GAH HAH .
VDL - JAP FAP GAP HAP .
VEL - KBH KBP .
VGL - JBH FBH GBH HBH .
VHL - JBP FBP GBP HBP .
VIL - KCH KCP .
VJL - HCP HCH .
VKL - JCH BCH FCH GCH .
VLL - JCP BCP FCP GCP .
VML - KDH KDP .
VOL - JDH FDH GDH HDH .
VPL - JDP FDP GDP HDP .
VST - BLA .
VTT - BLB .
VWM - BLC .
VXT - BLD .
W1M - CLC .
W5M - CLD .
W7T - EEH .
WCL - EAH BAH CAH .
WDL - EAP CAP DAP .
WGL - EBH BBH DBH .
WHL - EBP BBP .
WJT - DLB *** DLC .
WKL - ECH CCH DCH .
WLL - ECP CCP .
WOL - EDH BDH CDH DDH .
WPL - BDP CDP DDP .
WQM - CLA .
WRT - CLE .
WUM - CLB .
WWT - DLA .
X2M - OCH .
X6M - ODH .
X7P - ODP ODX .
XBP - LAH LAP .
XCP - AAH AAP .
XFP - LBH LBP .
XGP - ABH ABP .
XIP - LCH LCP .
XJP - OCP OCX .
XKP - ACH ACP .
XMP - LDP .
XNP - LDH .
XOP - ADH ADP .
XRM - OAH .
XSP - OAP OAX .
XTL - oep oem oen oeo .
XVM - OBH .
XWP - OBP OBX .
