*
* Connector Definitions
* Module: JC
* Description: Main Issue (VR Module Control)
* Revision: 
* 
ZAA ZAB - OBA .
ZAC ZAD - OBB .
ZAE ZAF - OBI .
ZAG ZAH - OBJ .

ZAI ZAJ - OBC .
ZAK ZAL - OBD .
ZAM ZAN - OBK .
ZAO ZAP - OBL .

ZAQ ZAR - OBE .
ZAS ZAT - OBF .
ZAU ZAV - OBM .
ZAW ZAX - OBN .

ZBA ZBB - OBG .
ZBC ZBD - OBH .
ZBE ZBF - OBO .
ZBG ZBH - OBP .

ZBI ZBJ - IED .
ZBK ZBL - IEC .
ZBM ZBN - OQA .
ZBO ZBP - OAA .

ZBQ ZBR - OAB .
ZBS ZBT - OAC .
ZBU ZBV - OAD .
ZBW ZBX - OAI .

ZCA ZCB - OAJ .
ZCC ZCD - OAK .
ZCE ZCF - OAL .
ZCG ZCH - IFA .

ZCI ZCJ - OAE .
ZCK ZCL - OAF .
ZCM ZCN - OAG .
ZCO ZCP - OAH .

ZCQ ZCR - OAM .
ZCS ZCT - OAN .
ZCU ZCV - OAO .
ZCW ZCX - OAP .

ZDA ZDB - OCA .
ZDC ZDD - OCB .
ZDE ZDF - OCI .
ZDG ZDH - OCJ .

ZDI ZDJ - OCC .
ZDK ZDL - OCD .
ZDM ZDN - OCK .
ZDO ZDP - OCL .

ZDQ ZDR - OCE .
ZDS ZDT - OCF .
ZDU ZDV - OCM .
ZDW ZDX - OCN .

ZEA ZEB - OCG .
ZEC ZED - OCH .
ZEE ZEF - OCO .
ZEG ZEH - OCP .

ZEI ZEJ - IEE .
ZEK ZEL - IDA .
ZEM ZEN - IBA .
ZEO ZEP - ODA .

ZEQ ZER - ODB .
ZES ZET - ODC .
ZEU ZEV - ODD .
ZEW ZEX - ODI .

ZFA ZFB - ODJ .
ZFC ZFD - ODK .
ZFE ZFF - ODL .
ZFG ZFH - IFB .

ZFI ZFJ - ODE .
ZFK ZFL - ODF .
ZFM ZFN - ODG .
ZFO ZFP - ODH .

ZFQ ZFR - ODM .
ZFS ZFT - ODN .
ZFU ZFV - ODO .
ZFW ZFX - ODP .

ZGA ZGB - OFA .
ZGC ZGD - OFB .
ZGE ZGF - OFI .
ZGG ZGH - OFJ .

ZGI ZGJ - OFC .
ZGK ZGL - OFD .
ZGM ZGN - OFK .
ZGO ZGP - OFL .

ZGQ ZGR - OFE .
ZGS ZGT - OFF .
ZGU ZGV - OFM .
ZGW ZGX - OFN .

ZHA ZHB - OFG .
ZHC ZHD - OFH .
ZHE ZHF - OFO .
ZHG ZHH - OFP .

ZHI ZHJ - ICA .
ZHK ZHL - ICB .
ZHM ZHN - OQB .
ZHO ZHP - OEA .

ZHQ ZHR - OEB .
ZHS ZHT - OEC .
ZHU ZHV - OED .
ZHW ZHX - OEI .

ZIA ZIB - OEJ .
ZIC ZID - OEK .
ZIE ZIF - OEL .
ZIG ZIH - IBE .

ZII ZIJ - OEE .
ZIK ZIL - OEF .
ZIM ZIN - OEG .
ZIO ZIP - OEH .

ZIQ ZIR - OEM .
ZIS ZIT - OEN .
ZIU ZIV - OEO .
ZIW ZIX - OEP .

ZJA ZJB - OGA .
ZJC ZJD - OGB .
ZJE ZJF - OGI .
ZJG ZJH - OGJ .

ZJI ZJJ - OGC .
ZJK ZJL - OGD .
ZJM ZJN - OGK .
ZJO ZJP - OGL .

ZJQ ZJR - OGE .
ZJS ZJT - OGF .
ZJU ZJV - OGM .
ZJW ZJX - OGN .

ZKA ZKB - OGG .
ZKC ZKD - OGH .
ZKE ZKF - OGO .
ZKG ZKH - OGP .

ZKI ZKJ - IZZ .
ZKK ZKL - IDB .
ZKM ZKN - IBB .
ZKO ZKP - OHA .

ZKQ ZKR - OHB .
ZKS ZKT - OHC .
ZKU ZKV - OHD .
ZKW ZKX - OHI .

ZLA ZLB - OHJ .
ZLC ZLD - OHK .
ZLE ZLF - OHL .
ZLG ZLH - IFC .

ZLI ZLJ - OHE .
ZLK ZLL - OHF .
ZLM ZLN - OHG .
ZLO ZLP - OHH .

ZLQ ZLR - OHM .
ZLS ZLT - OHN .
ZLU ZLV - OHO .
ZLW ZLX - OHP .

ZMA ZMB - OJA .
ZMC ZMD - OJB .
ZME ZMF - OJI .
ZMG ZMH - OJJ .

ZMI ZMJ - OJC .
ZMK ZML - OJD .
ZMM ZMN - OJK .
ZMO ZMP - OJL .

ZMQ ZMR - OJE .
ZMS ZMT - OJF .
ZMU ZMV - OJM .
ZMW ZMX - OJN .

ZNA ZNB - OJG .
ZNC ZND - OJH .
ZNE ZNF - OJO .
ZNG ZNH - OJP .

ZNI ZNJ - IEA .
ZNK ZNL - IEB .
ZNM ZNN - OQC .
ZNO ZNP - OIA .

ZNQ ZNR - OIB .
ZNS ZNT - OIC .
ZNU ZNV - OID .
ZNW ZNX - OII .

ZOA ZOB - OIJ .
ZOC ZOD - OIK .
ZOE ZOF - OIL .
ZOG ZOH - IFD .

ZOI ZOJ - OIE .
ZOK ZOL - OIF .
ZOM ZON - OIG .
ZOO ZOP - OIH .

ZOQ ZOR - OIM .
ZOS ZOT - OIN .
ZOU ZOV - OIO .
ZOW ZOX - OIP .

ZPA ZPB - OKA .
ZPC ZPD - OKB .
ZPE ZPF - OKI .
ZPG ZPH - OKJ .

ZPI ZPJ - OKC .
ZPK ZPL - OKD .
ZPM ZPN - OKK .
ZPO ZPP - OKL .

ZPQ ZPR - OKE .
ZPS ZPT - OKF .
ZPU ZPV - OKM .
ZPW ZPX - OKN .

ZQA ZQB - OKG .
ZQC ZQD - OKH .
ZQE ZQF - OKO .
ZQG ZQH - OKP .

ZQI ZQJ - IHA .
ZQK ZQL - IDC .
ZQM ZQN - IBC .
ZQO ZQP - OLA .

ZQQ ZQR - OLB .
ZQS ZQT - OLC .
ZQU ZQV - OLD .
ZQW ZQX - OLI .

ZRA ZRB - OLJ .
ZRC ZRD - OLK .
ZRE ZRF - OLL .
ZRG ZRH - IFE .

ZRI ZRJ - OLE .
ZRK ZRL - OLF .
ZRM ZRN - OLG .
ZRO ZRP - OLH .

ZRQ ZRR - OLM .
ZRS ZRT - OLN .
ZRU ZRV - OLO .
ZRW ZRX - OLP .

ZSA ZSB - ONA .
ZSC ZSD - ONB .
ZSE ZSF - ONI .
ZSG ZSH - ONJ .

ZSI ZSJ - ONC .
ZSK ZSL - OND .
ZSM ZSN - ONK .
ZSO ZSP - ONL .

ZSQ ZSR - ONE .
ZSS ZST - ONF .
ZSU ZSV - ONM .
ZSW ZSX - ONN .

ZTA ZTB - ONG .
ZTC ZTD - ONH .
ZTE ZTF - ONO .
ZTG ZTH - ONP .

ZTI ZTJ - IAA .
ZTK ZTL - IAB .
ZTM ZTN - OQD .
ZTO ZTP - OMA .

ZTQ ZTR - OMB .
ZTS ZTT - OMC .
ZTU ZTV - OMD .
ZTW ZTX - OMI .

ZUA ZUB - OMJ .
ZUC ZUD - OMK .
ZUE ZUF - OML .
ZUG ZUH - IGA .

ZUI ZUJ - OME .
ZUK ZUL - OMF .
ZUM ZUN - OMG .
ZUO ZUP - OMH .

ZUQ ZUR - OMM .
ZUS ZUT - OMN .
ZUU ZUV - OMO .
ZUW ZUX - OMP .

ZVA ZVB - OOA .
ZVC ZVD - OOB .
ZVE ZVF - OOI .
ZVG ZVH - OOJ .

ZVI ZVJ - OOC .
ZVK ZVL - OOD .
ZVM ZVN - OOK .
ZVO ZVP - OOL .

ZVQ ZVR - OOE .
ZVS ZVT - OOF .
ZVU ZVV - OOM .
ZVW ZVX - OON .

ZWA ZWB - OOG .
ZWC ZWD - OOH .
ZWE ZWF - OOO .
ZWG ZWH - OOP .

ZWI ZWJ - IHB .
ZWK ZWL - IDD .
ZWM ZWN - IBD .
ZWO ZWP - OPA .

ZWQ ZWR - OPB .
ZWS ZWT - OPC .
ZWU ZWV - OPD .
ZWW ZWX - OPI .

ZXA ZXB - OPJ .
ZXC ZXD - OPK .
ZXE ZXF - OPL .
ZXG ZXH - IFF .

ZXI ZXJ - OPE .
ZXK ZXL - OPF .
ZXM ZXN - OPG .
ZXO ZXP - OPH .

ZXQ ZXR - OPM .
ZXS ZXT - OPN .
ZXU ZXV - OPO .
ZXW ZXX - OPP .
