*
* Connector Definitions
* Module: MA
* Description: Floating multiply, reciprocal, reciprocal square root
* Revision: 
* Date: 
*
ZAA ZAB - IFA .
ZAC ZAD - IFJ .
ZAE ZAF - IFM .
ZAG ZAH - IFL .
ZAI ZAJ - IFK .
ZAK ZAL - IFD .
ZAM ZAN - IFF .
ZAO ZAP - IFI .
ZAQ ZAR - IFH .
ZAS ZAT - IFG .
ZAU ZAV - IFB .
ZAW ZAX - IFE .
ZBA ZBB - IFC .
ZBC ZBD - IAJ .
ZBE ZBF - IAK .
ZBG ZBH - IAL .
ZBI ZBJ - OGM .
ZBK ZBL - IAB .
ZBM ZBN - IAC .
ZBO ZBP - OGP .
ZBQ ZBR - IFP .
ZBS ZBT - IFO .
ZBU ZBV - IFN .
ZBW ZBX - IAD .
ZCA ZCB - IAE .
ZCC ZCD - IAF .
ZCE ZCF - OGO .
ZCG ZCH - IAG .
ZCI ZCJ - IAH .
ZCK ZCL - IAI .
ZCM ZCN - OGN .
ZCO ZCP - *** .
ZCQ ZCR - *** .
ZCS ZCT - IAA .
ZCU ZCV - IBA .
ZCW ZCX - IBB .
   
ZDA ZDB - ICD .
ZDC ZDD - OBB .
ZDE ZDF - OGI .
ZDG ZDH - IEB .
ZDI ZDJ - IEA .
ZDK ZDL - OGL .
ZDM ZDN - IAM .
ZDO ZDP - IAN .
ZDQ ZDR - IAO .
ZDS ZDT - OGK .
ZDU ZDV - IAP .
ZDW ZDX - OGJ .
ZEA ZEB - *** .
ZEC ZED - IBC .
ZEE ZEF - IBD .
ZEG ZEH - IBE .
ZEI ZEJ - IBF .
ZEK ZEL - IBG .
ZEM ZEN - IBH .
ZEO ZEP - IBI .
ZEQ ZER - IBJ .
ZES ZET - IBK .
ZEU ZEV - IBL .
ZEW ZEX - IBM .
ZFA ZFB - IBN .
ZFC ZFD - IBO .
ZFE ZFF - IBP .
ZFG ZFH - *** .
ZFI ZFJ - *** .
ZFK ZFL - *** .
ZFM ZFN - *** .
ZFO ZFP - *** .
ZFQ ZFR - *** .
ZFS ZFT - *** .
ZFU ZFV - *** .
ZFW ZFX - *** .
   
ZGA ZGB - OHJ .
ZGC ZGD - OIJ .
ZGE ZGF - OAD .
ZGG ZGH - ICC .
ZGI ZGJ - OAC .
ZGK ZGL - OBC .
ZGM ZGN - OHH .
ZGO ZGP - OIH .
ZGQ ZGR - ICB .
ZGS ZGT - OBA .
ZGU ZGV - OHB .
ZGW ZGX - OAB .
ZHA ZHB - IGA .
ZHC ZHD - IHA .
ZHE ZHF - IKA .
ZHG ZHH - ODA .
ZHI ZHJ - OEA .
ZHK ZHL - OHI .
ZHM ZHN - OHK .
ZHO ZHP - OII .
ZHQ ZHR - IDA .
ZHS ZHT - IDB .
ZHU ZHV - ODB .
ZHW ZHX - OEB .
ZIA ZIB - OBD .
ZIC ZID - IDC .
ZIE ZIF - IDD .
ZIG ZIH - ODD .
ZII ZIJ - OED .
ZIK ZIL - OHD .
ZIM ZIN - IRA .
ZIO ZIP - ISA .
ZIQ ZIR - ITA .
ZIS ZIT - ODC .
ZIU ZIV - OEC .
ZIW ZIX - *** .
   
ZJA ZJB - OQJ .
ZJC ZJD - OPK .
ZJE ZJF - OQK .
ZJG ZJH - OPM .
ZJI ZJJ - OQM .
ZJK ZJL - OKD .
ZJM ZJN - OAH .
ZJO ZJP - OBH .
ZJQ ZJR - ICG .
ZJS ZJT - ICH .
ZJU ZJV - OAG .
ZJW ZJX - OBG .
ZKA ZKB - OCG .
ZKC ZKD - ICE .
ZKE ZKF - ICF .
ZKG ZKH - OAE .
ZKI ZKJ - OBE .
ZKK ZKL - OHG .
ZKM ZKN - OAF .
ZKO ZKP - OBF .
ZKQ ZKR - ODE .
ZKS ZKT - OEE .
ZKU ZKV - OLD .
ZKW ZKX - OKC .
ZLA ZLB - OKF .
ZLC ZLD - IDE .
ZLE ZLF - ODF .
ZLG ZLH - OEF .
ZLI ZLJ - OCH .
ZLK ZLL - OMB .
ZLM ZLN - ONB .
ZLO ZLP - IDG .
ZLQ ZLR - ODH .
ZLS ZLT - OEH .
ZLU ZLV - OFH .
ZLW ZLX - ODG .
   
ZMA ZMB - OEG .
ZMC ZMD - OFG .
ZME ZMF - OQQ .
ZMG ZMH - OPQ .
ZMI ZMJ - OPR .
ZMK ZML - OMA .
ZMM ZMN - OPO .
ZMO ZMP - OQO .
ZMQ ZMR - OAL .
ZMS ZMT - OCL .
ZMU ZMV - ICK .
ZMW ZMX - ICL .
ZNA ZNB - OAK .
ZNC ZND - OBK .
ZNE ZNF - OCK .
ZNG ZNH - ICI .
ZNI ZNJ - ICJ .
ZNK ZNL - OAI .
ZNM ZNN - OBI .
ZNO ZNP - OCI .
ZNQ ZNR - OAJ .
ZNS ZNT - OBJ .
ZNU ZNV - OCJ .
ZNW ZNX - OKE .
ZOA ZOB - OKA .
ZOC ZOD - ODI .
ZOE ZOF - OEI .
ZOG ZOH - OFI .
ZOI ZOJ - IDI .
ZOK ZOL - IDJ .
ZOM ZON - ODJ .
ZOO ZOP - OEJ .
ZOQ ZOR - OFJ .
ZOS ZOT - OBL .
ZOU ZOV - IDK .
ZOW ZOX - IDL .
   
ZPA ZPB - ODL .
ZPC ZPD - OEL .
ZPE ZPF - OFL .
ZPG ZPH - OKB .
ZPI ZPJ - ODK .
ZPK ZPL - OEK .
ZPM ZPN - OFK .
ZPO ZPP - OHE .
ZPQ ZPR - OAP .
ZPS ZPT - OBP .
ZPU ZPV - OHF .
ZPW ZPX - ICO .
ZQA ZQB - ICP .
ZQC ZQD - OAO .
ZQE ZQF - OBO .
ZQG ZQH - OCO .
ZQI ZQJ - OHA .
ZQK ZQL - ICM .
ZQM ZQN - ICN .
ZQO ZQP - OAM .
ZQQ ZQR - OBM .
ZQS ZQT - OCM .
ZQU ZQV - OAN .
ZQW ZQX - OCN .
ZRA ZRB - OBN .
ZRC ZRD - ODM .
ZRE ZRF - OEM .
ZRG ZRH - OFM .
ZRI ZRJ - OHC .
ZRK ZRL - IDM .
ZRM ZRN - IDN .
ZRO ZRP - ODN .
ZRQ ZRR - OFN .
ZRS ZRT - OEN .
ZRU ZRV - OCP .
ZRW ZRX - IDO .
   
ZSA ZSB - IDP .
ZSC ZSD - ODP .
ZSE ZSF - OEP .
ZSG ZSH - OFP .
ZSI ZSJ - ODO .
ZSK ZSL - OEO .
ZSM ZSN - OFO .
ZSO ZSP - ICA .
ZSQ ZSR - OAA .
ZSS ZST - IEL .
ZSU ZSV - IEM .
ZSW ZSX - IEN .
ZTA ZTB - OGE .
ZTC ZTD - IEE .
ZTE ZTF - IED .
ZTG ZTH - IEC .
ZTI ZTJ - OGH .
ZTK ZTL - IEH .
ZTM ZTN - IEG .
ZTO ZTP - IEF .
ZTQ ZTR - OGF .
ZTS ZTT - OGG .
ZTU ZTV - IEK .
ZTW ZTX - IEJ .
ZUA ZUB - IEI .
ZUC ZUD - IDF .
ZUE ZUF - IDH .
ZUG ZUH - *** .
ZUI ZUJ - *** .
ZUK ZUL - *** .
ZUM ZUN - *** .
ZUO ZUP - *** .
ZUQ ZUR - *** .
ZUS ZUT - *** .
ZUU ZUV - *** .
ZUW ZUX - *** .
   
ZVA ZVB - OGA .
ZVC ZVD - IMS .
ZVE ZVF - IMM .
ZVG ZVH - IMR .
ZVI ZVJ - IEX .
ZVK ZVL - IEY .
ZVM ZVN - IEZ .
ZVO ZVP - OGD .
ZVQ ZVR - IEO .
ZVS ZVT - IEP .
ZVU ZVV - IEQ .
ZVW ZVX - OGC .
ZWA ZWB - IER .
ZWC ZWD - IES .
ZWE ZWF - IET .
ZWG ZWH - OGB .
ZWI ZWJ - IEU .
ZWK ZWL - IEV .
ZWM ZWN - IEW .
ZWO ZWP - *** .
ZWQ ZWR - *** .
ZWS ZWT - *** .
ZWU ZWV - *** .
ZWW ZWX - *** .
ZXA ZXB - *** .
ZXC ZXD - *** .
ZXE ZXF - *** .
ZXG ZXH - *** .
ZXI ZXJ - *** .
ZXK ZXL - *** .
ZXM ZXN - *** .
ZXO ZXP - *** .
ZXQ ZXR - *** .
ZXS ZXT - *** .
ZXU ZXV - *** .                
ZXW ZXX - *** .               
