*
* Connector Definitions
* Module: AM
* Description: Address Multiply
* Revision:
* Date:
*
ZAA ZAB - OAA .
ZAC ZAD - OAB .
ZAE ZAF - OAC .
ZAG ZAH - OAD .
ZAI ZAJ - OAE .
ZAK ZAL - OAF .
ZAM ZAN - OAG .
ZAO ZAP - OAH .
ZAQ ZAR - OAI .
ZAS ZAT - OAJ .
ZAU ZAV - OAK .
ZAW ZAX - OAL .
ZBA ZBB - OAM .
ZBC ZBD - OAN .
ZBE ZBF - OAO .
ZBG ZBH - OAP .
ZBI ZBJ - OBA .
ZBK ZBL - OBB .
ZBM ZBN - OBC .
ZBO ZBP - OBD .
ZBQ ZBR - OBE .
ZBS ZBT - OBF .
ZBU ZBV - OBG .
ZBW ZBX - OBH .
ZCA ZCB - OBI .
ZCC ZCD - OBJ .
ZCE ZCF - OBK .
ZCG ZCH - OBL .
ZCI ZCJ - OBM .
ZCK ZCL - OBN .
ZCM ZCN - OBO .
ZCO ZCP - OBP .
ZCQ ZCR - IAA .
ZCS ZCT - IAB .
ZCU ZCV - IAC .
ZCW ZCX - IAD .
  
ZDA ZDB - IAE .
ZDC ZDD - IAF .
ZDE ZDF - IAG .
ZDG ZDH - IAH .
ZDI ZDJ - IAI .
ZDK ZDL - IAJ .
ZDM ZDN - IAK .
ZDO ZDP - IAL .
ZDQ ZDR - IAM .
ZDS ZDT - IAN .
ZDU ZDV - IAO .
ZDW ZDX - IAP .
ZEA ZEB - IBA .
ZEC ZED - IBB .
ZEE ZEF - IBC .
ZEG ZEH - IBD .
ZEI ZEJ - IBE .
ZEK ZEL - IBF .
ZEM ZEN - IBG .
ZEO ZEP - IBH .
ZEQ ZER - IBI .
ZES ZET - IBJ .
ZEU ZEV - IBK .
ZEW ZEX - IBL .
ZFA ZFB - IBM .
ZFC ZFD - IBN .
ZFE ZFF - IBO .
ZFG ZFH - IBP .
ZFI ZFJ - ICA .
ZFK ZFL - ICB .
ZFM ZFN - ICC .
ZFO ZFP - ICD .
ZFQ ZFR - ICE .
ZFS ZFT - ICF .
ZFU ZFV - ICG .
ZFW ZFX - ICH .
  
ZGA ZGB - ICI .
ZGC ZGD - ICJ .
ZGE ZGF - ICK .
ZGG ZGH - ICL .
ZGI ZGJ - ICM .
ZGK ZGL - ICN .
ZGM ZGN - ICO .
ZGO ZGP - ICP .
ZGQ ZGR - IDA .
ZGS ZGT - IDB .
ZGU ZGV - IDC .
ZGW ZGX - IDD .
ZHA ZHB - IDE .
ZHC ZHD - IDF .
ZHE ZHF - IDG .
ZHG ZHH - IDH .
ZHI ZHJ - IDI .
ZHK ZHL - IDJ .
ZHM ZHN - IDK .
ZHO ZHP - IDL .
ZHQ ZHR - IDM .
ZHS ZHT - IDN .
ZHU ZHV - IDO .
ZHW ZHX - IDP .
ZIA ZIB - IHA . 
ZIC ZID - OIA . 
ZIE ZIF - OIB . 
ZIG ZIH - *** . 
ZII ZIJ - *** . 
ZIK ZIL - *** . 
ZIM ZIN - *** . 
ZIO ZIP - *** . 
ZIQ ZIR - *** . 
ZIS ZIT - *** . 
ZIU ZIV - OIC . 
ZIW ZIX - OID . 
  
ZJA ZJB - OIE . 
ZJC ZJD - OIF . 
ZJE ZJF - OJA . 
ZJG ZJH - OJB . 
ZJI ZJJ - OJC . 
ZJK ZJL - OJD . 
ZJM ZJN - OJE . 
ZJO ZJP - OJF . 
ZJQ ZJR - OKA . 
ZJS ZJT - OKB . 
ZJU ZJV - OEA . 
ZJW ZJX - OEB . 
ZKA ZKB - OEC . 
ZKC ZKD - OED . 
ZKE ZKF - OEE . 
ZKG ZKH - OEF . 
ZKI ZKJ - OKC . 
ZKK ZKL - OFA . 
ZKM ZKN - OFB . 
ZKO ZKP - OFC . 
ZKQ ZKR - OFD . 
ZKS ZKT - OFE . 
ZKU ZKV - OFF . 
ZKW ZKX - OKD . 
ZLA ZLB - OGA . 
ZLC ZLD - OGB . 
ZLE ZLF - OGC . 
ZLG ZLH - OGD . 
ZLI ZLJ - OGE . 
ZLK ZLL - OGF . 
ZLM ZLN - OKE . 
ZLO ZLP - OHA . 
ZLQ ZLR - OHB . 
ZLS ZLT - OHC . 
ZLU ZLV - OHD . 
ZLW ZLX - OHE . 
  
ZMA ZMB - OHF . 
ZMC ZMD - OKF . 
ZME ZMF - IGA . 
ZMG ZMH - IGB . 
ZMI ZMJ - IGC . 
ZMK ZML - IGD . 
ZMM ZMN - IGE . 
ZMO ZMP - IGF . 
ZMQ ZMR - OLA . 
ZMS ZMT - OLB . 
ZMU ZMV - OLC . 
ZMW ZMX - OLD . 
ZNA ZNB - OLE . 
ZNC ZND - OLF . 
ZNE ZNF - OMA . 
ZNG ZNH - OMB . 
ZNI ZNJ - OMC . 
ZNK ZNL - OMD . 
ZNM ZNN - OME . 
ZNO ZNP - OMF . 
ZNQ ZNR - ONA . 
ZNS ZNT - ONB . 
ZNU ZNV - ONC . 
ZNW ZNX - OND . 
ZOA ZOB - ONE . 
ZOC ZOD - ONF . 
ZOE ZOF - OOA . 
ZOG ZOH - OOB . 
ZOI ZOJ - OOC . 
ZOK ZOL - OOD . 
ZOM ZON - OOE . 
ZOO ZOP - OOF . 
ZOQ ZOR - OPA . 
ZOS ZOT - OPB . 
ZOU ZOV - OPC . 
ZOW ZOX - OPD . 
  
ZPA ZPB - OPE . 
ZPC ZPD - OPF . 
ZPE ZPF - OIG . 
ZPG ZPH - OIH . 
ZPI ZPJ - OIJ . 
ZPK ZPL - OIK . 
ZPM ZPN - OIL . 
ZPO ZPP - OIM . 
ZPQ ZPR - OJG . 
ZPS ZPT - OJH . 
ZPU ZPV - OJI . 
ZPW ZPX - OJJ . 
ZQA ZQB - OJK . 
ZQC ZQD - OJL . 
ZQE ZQF - OJM . 
ZQG ZQH - OKG . 
ZQI ZQJ - OKH . 
ZQK ZQL - OKI . 
ZQM ZQN - OKJ . 
ZQO ZQP - OKK . 
ZQQ ZQR - OKL . 
ZQS ZQT - OKM . 
ZQU ZQV - OLG . 
ZQW ZQX - OLH . 
ZRA ZRB - OLI . 
ZRC ZRD - OLJ . 
ZRE ZRF - OLK . 
ZRG ZRH - OLL . 
ZRI ZRJ - OLM . 
ZRK ZRL - OMG . 
ZRM ZRN - OMH . 
ZRO ZRP - OMI . 
ZRQ ZRR - OMJ . 
ZRS ZRT - OMK . 
ZRU ZRV - OML . 
ZRW ZRX - ONG . 
 
ZSA ZSB - ONH . 
ZSC ZSD - ONI . 
ZSE ZSF - ONJ . 
ZSG ZSH - ONK . 
ZSI ZSJ - ONL . 
ZSK ZSL - ONM . 
ZSM ZSN - OOG . 
ZSO ZSP - OOH . 
ZSQ ZSR - OOI . 
ZSS ZST - OOJ . 
ZSU ZSV - OOK . 
ZSW ZSX - OOL . 
ZTA ZTB - OOM . 
ZTC ZTD - OPG . 
ZTE ZTF - OPH . 
ZTG ZTH - OPI . 
ZTI ZTJ - OPJ . 
ZTK ZTL - OPK . 
ZTM ZTN - OPL . 
ZTO ZTP - OPM . 
ZTQ ZTR - *** . 
ZTS ZTT - *** . 
ZTU ZTV - *** . 
ZTW ZTX - *** . 
ZUA ZUB - *** . 
ZUC ZUD - *** . 
ZUE ZUF - *** . 
ZUG ZUH - *** . 
ZUI ZUJ - *** . 
ZUK ZUL - *** . 
ZUM ZUN - *** . 
ZUO ZUP - *** . 
ZUQ ZUR - *** . 
ZUS ZUT - *** . 
ZUU ZUV - *** . 
ZUW ZUX - *** . 
   
ZVA ZVB - IEA . 
ZVC ZVD - IEB . 
ZVE ZVF - IEC . 
ZVG ZVH - IED . 
ZVI ZVJ - IEE . 
ZVK ZVL - IEF . 
ZVM ZVN - IFA . 
ZVO ZVP - IFB . 
ZVQ ZVR - IFC . 
ZVS ZVT - IFD . 
ZVU ZVV - IFE . 
ZVW ZVX - IFF . 
ZWA ZWB - IFG . 
ZWC ZWD - *** . 
ZWE ZWF - *** . 
ZWG ZWH - *** . 
ZWI ZWJ - *** . 
ZWK ZWL - *** . 
ZWM ZWN - *** . 
ZWO ZWP - *** . 
ZWQ ZWR - *** . 
ZWS ZWT - *** . 
ZWU ZWV - *** . 
ZWW ZWX - *** . 
ZXA ZXB - *** . 
ZXC ZXD - *** . 
ZXE ZXF - *** . 
ZXG ZXH - *** . 
ZXI ZXJ - *** . 
ZXK ZXL - *** . 
ZXM ZXN - *** . 
ZXO ZXP - *** . 
ZXQ ZXR - *** . 
ZXS ZXT - *** . 
ZXU ZXV - *** . 
ZXW ZXX - *** .  
