*
* Package Definitions
* Module: VL
* Description: Vector Logical, Real-time counter, vector mask register
* Revision:
* Date: 
*
A1X - JMA .
A2X - JMB .
A3X - JMC .
A4X - JMD .
A5L - QLE QVC .
A6L - QLC .
A7L - QJD .
A8M - QJC .
AAH - VAF .
ABM - QIC .
ACP - QKD .
ADO - NAA NAB NAC .
AEL - QKE .
AFB - VAG .
AGL - THA THB THC THD .
AHO - NBA NBB NBC .
AIL - the thf thg thh .
ALO - NCA NCB NCC .
APO - NDA NDB NDC .
AQF - JSA JSB JSC JSD JSE JSF JSG JSH JSI .
ARF - JTA JTB JTC JTD JTE JTF JTG JTH JTI .
ASF - JUA JUB JUC JUD JUE JUF JUG JUH JUI .
ATL - RIA RIB RIC RID .
AUL - RIE RIF RIG RIH .
AVL - RJA RJB RJC RJD .
AWL - RJE RJF RJG RJH .
B1L - TBA TBB TBC TBD .
B2L - TEA TEB .
B3L - TEE TEF .
B4L - TFA TFB TFC TFD .
B5L - TFE TFF TFG TFH .
B6L - TCA TCB TCC TCD .
B7L - TEC TED .
B8L - TEG TEH .
BAA - CAA .
BBA - CBA .
BCA - CCA . 
BDA - CDA .
BEA - CEA .
BFA - CFA .
BGA - CGA .
BHA - CHA .
BIX - MAA .
BJX - MBA .
BKX - MCA .
BLK - MDA .
BMX - MEA .
BNX - MFA .
BOX - MGA .
BPX - MHA .
BSO - EAA EAB EAC .
BTO - EBA EBB EBC .
BUO - ECA ECB ECC .
BVO - EDA EDB EDC .
C1L - QBD QBE QBF QBG .
C2P - QAD .
C3L - QAA QAB QAC .
C4O - SAA SAB SAC .
C5O - SBA SBB SBC .
C6O - SCA SCB SCC .
C7O - SDA SDB SDC .
C8L - QAE QAF QAG .
CBL - BAA BAB BAC .
CCL - DAA DAB DAC .
CDO - AAA AAB AAC .
CFL - BCA BCB BCC .
CGO - DBA DBB DBC .
CHO - ACA ACB ACC .
CIH - JRA .
CJH - JRB .
CKL - BEA BEB BEC .
CLL - DCA DCB DCC .
CMO - AEA AEB AEC .
CNH - JRC .
COL - BGA BGB BGC .
CPL - DDA DDB DDC .
CQO - AGA AGB AGC .
CRX - OAA .
CSX - OAI .
CTX - OBA .
CUX - OBI .
CVX - OCA .
CWX - OCI .
CXX - ODA .
DDO - NAD NAE NAF .
DEM - UAA .
DFM - UAB .
DGM - UAC .
DHO - NBD NBE NBF .
DLO - NCD NCE NCF .
DPO - NDD NDE NDF .
DQL - TDA TDB TDC TDD .
DRL - tde tdf tdg tdh .
DTL - RKA RKB RKC RKD .
DUL - RKE RKF RKG RKH .
DVL - RLA RLB RLC RLD .
DWL - RLE RLF RLG RLH .
EAA - CAB .
EBA - CBB .
ECA - CCB .
EDA - CDB .
EEA - CEB . 
EFA - CFB .
EGA - CGB .
EHA - CHB .
EIX - MAB .
EJX - MBB .
EKX - MCB .
ELX - MDB .
EMX - MEB .
ENX - MFB .
EOX - MGB .
EPX - MHB .
EQX - qqh .
ERX - qrh .
ESO - EAD EAE EAF .
ETO - EBD EBE EBF .
EUO - ECD ECE ECF .
EVO - EDD EDE EDF .
F1O - SAD SAE SAF .
F2O - SBD SBE SBF .
F3O - SCD SCE SCF .
F4O - SDD SDE SDF .
F5L - TGA TGB TGC TGD .
F6L - tge tgf tgg tgh .
F7L - QCA QCB QCC QCD .
F8L - QDA QDB .
FAL - QDC QDD .
FBL - BAD BAE BAF .
FCL - DAD DAE DAF .
FDO - AAD AAE AAF .
FEL - BCD BCE BCF .
FFL - DBD DBE DBF .
FGO - ACD ACE ACF .
FHL - BED BEE BEF .
FIL - QFA QFB QFC .
FJH - VAH .
FKL - DCD DCE DCF .
FLO - AED AEE AEF .
FNL - BGD BGE BGF .
FOL - DDD DDE DDF .
FPO - AGD AGE AGF .
FQX - OAB .
FRX - OAJ .
FSX - OBB .
FTX - OBJ .
FUX - OCB .
FWX - OCJ .
FXX - ODB .
GCL - TAA TAB TAC TAD .
GDO - NAG NAH NAI .
GEL - tae taf tag tah .
GHO - NBG NBH NBI .
GLO - NCG NCH NCI .
GPO - NDG NDH NDI .
GTL - RMA RMB RMC RMD .
GUL - RME RMF RMG RMH .
GVL - RNA RNB RNC RND .
GWL - RNE RNF RNG RNH .
H1L - TJA TJB TJC TJD .
H2L - TIA TIB TIC TID .
H3L - TKA TKB TKC TKD .
H4J - JNA JNB .
H5J - JQA JQB .
H6L - tke tkf tkg tkh .
HAA - CAC .
HBA - CBC .
HCA - CCC .
HDA - CDC .
HEA - CEC .
HFA - CFC .
HGA - CGC .
HHA - CHC .
HIX - MAC .
HJX - MBC .
HKX - MCC .
HLX - MDC .
HMX - MEC .
HNX - MFC .
HOX - MGC .
HPX - MHC .
HQH - JRD .
HRH - JRE .
HSO - EAG EAH .
HTO - EBG EBH .
HUO - ECG ECH .
HVO - EDG EDH .
HWH - JRF .
HXH - JRG .
I1O - SAG SAH .
I2O - SBG SBH .
I3O - SCG SCH .
I4O - SDG SDH .
I5L - QSA QSB QSC QSD .
I6L - QSE QTA QTB QTC .
I7L - QTD QTE QUA QUB .
I8M - QSF .
IBL - BAG BAH .
ICL - DAG DAH QSG .
IDO - AAG AAH .
IEH - JRH .
IFL - BCG BCH .
IGL - DBG DBH .
IHO - ACG ACH .
IIL - BEG BEH .
IJM - UAD .
IKL - DCG DCH .
ILO - AEG AEH .
IMM - UAE .
INL - BGG BGH .
IOL - DDG DDH .
IPO - AGG AGH .
IQX - OAC .
IRX - OAK .
ISX - OBC .
ITX - OBK .
IUX - OCC .
IVM - UAF .
IWX - OCK .
IXX - ODC .
JAH - JRI .
JBH - JRJ .
JCH - JRK .
JDO - NAJ NAK NAL .
JEH - JRL .
JFM - QTF .
JGL - QTG .
JHO - NBJ NBK NBL .
JII - VAA .
JJK - VAB .
JKA - VAC .
JLO - NCJ NCK NCL .
JMC - VAD .
JND - VAE .
JPO - NDJ NDK NDL .
JTL - ROA ROB ROC ROD .
JUL - ROE ROF ROG ROH .
JVL - RPA RPB RPC RPD .
JWL - RPE RPF RPG RPH .
KAA - CAD .
KBA - CBD .
KCA - CCD .
KDA - CDD .
KEA - CED .
KFA - CFD .
KGA - CGD .
KHA - CHD .
KIX - MAD .
KJX - MBD .
KKX - MCD .
KLX - MDD .
KMX - MED .
KNX - MFD .
KOX - MGD .
KPX - MHD .
KQL - QHE QHF QGE QGF .
KRX - QLD .
KSO - EEA EEB EEC .
KTO - EFA EFB EFC .
KUO - EGA EGB EGC .
KVO - EHA EHB EHC .
KWX - QHD .
KXM - QHC .
L1O - SEA SEB SEC .
L2O - SFA SFB SFC .
L3O - SGA SGB SGC .
L4O - SHA SHB SHC .
LAX - QGD .
LBL - BBA BBB BBC .
LCL - DAI DAJ DAK .
LDO - ABA ABB ABC .
LEM - QGC .
LFL - BDA BDB BDC .
LGL - DBI DBJ DBK .
LHO - ADA ADB ADC .
LJL - BFA BFB BFC .
LKL - DCI DCJ DCK .
LLO - AFA AFB AFC .
LNL - BHA BHB BHC .
LOL - DDI DDJ DDK .
LPO - AHA AHB AHC .
LQX - OAD .
LRX - OAL .
LSX - OBD .
LTX - OBL .
LUX - OCD .
LVX - OCL .
LWX - ODD .
LXX - ODL .
MDO - NAM NAN NAO .
MHO - NBM NBN NBO .
MLO - NCM NCN NCO .
MPO - NDM NDN NDO .
MSL - QMA QMB QMC QMD .
MTL - QNA QNB QNC QND .
MUI - JEA JEB .
MVI - JEC JED .
MWO - NIH .
MXL - QNF .
NAA - CAE .
NBA - CBE .
NCA - CCE .
NDA - CDE .
NEA - CEE .
NFA - CFE .
NGA - CGE .
NHA - CHE .
NIX - MAE .
NJX - MBE .
NKX - MCE .
NLX - MDE .
NMX - MEE .
NNX - MFE .
NOX - MGE .
NPX - MHE .
NSO - EED EEE EEF .
NTO - EFD EFE EFF .
NUO - EGD EGE EGF .
NVO - EHD EHE EHF .
O1O - SEG  .
O2O - SFG SFH .
O3O - SGG SGH .
O4O - SHG SHH .
O5O - SEH .
OBL - BBD BBE BBF .
OCL - DAL DAM DAN .
ODO - ABD ABE ABF .
OFL - BDD BDE BDF .
OGL - DBL DBM DBN .
OHO - ADD ADE ADF .
OIX - ODO .
OJL - BFD BFE BFF .
OKL - DCL DCM DCN .
OLO - AFD AFE AFF .
OMX - ODP .
ONL - BHD BHE BHF .
OOL - DDL DDM DDN .
OPO - AHD AHE AHF .
OQX - OAE .
ORX - OAM .
OSX - OBE .
OTX - OBM .
OUX - OCE .
OVX - OCM . 
OWX - ODE .
OXX - ODM .
PDO - NAP .
PHO - NBP .
PLO - NCP .
PPO - NDP .
QAA - CAF .
QBA - CBF .
QCA - CCF .
QDA - CDF .
QEA - CEF .
QFA - CFF .
QGA - CGF .
QHA - CHF .
QIX - MAF .
QJX - MBF .
QKX - MCF .
QLX - MDF .
QMX - MEF .
QNX - MFF .
QOX - MGF .
QPX - MHF .
QRO - EEG EEH .
QSO - EFG EFH .
QTO - EGG EGH .
QUO - EHG EHH .
R1O - SAO SAP .
R2O - SBO SBP .
R3O - SCO SCP .
R4O - SDO SDP .
RBL - BBG BBH .
RCL - DAO DAP .
RDO - ABG ABH .
RFL - BDG BDH .
RGL - DBO DBP .
RHO - ADG ADH .
RJL - BFG BFH .
RKL - DCO DCP .
RLO - AFG AFH .
RML - BIP BJP BKP BLP .
RNL - BHG BHH .
ROL - DDO DDP .
RPO - AHG AHH .
RQX - OAF .
RRX - OAN .
RSX - OBF .
RTX - OBN .
RUX - OCF .
RVX - OCN .
RWX - ODF .
RXX - ODN .
TAA - CAG .
TBA - CBG .
TCA - CCG .
TDA - CDG .
TEA - CEG .
TFA - CFG .
TGA - CGG .
THA - CHG .
TIX - MAG .
TJX - MBG .
TKX - MCG .
TLX - MDG .
TMX - MEG .
TNX - MFG .
TOX - MGG .
TPX - MHG .
U1O - SED SEE SEF .
U2O - SFD SFE SFF .
U3O - SGD SGE SGF .
U4O - SHD SHE SHF .
UMX - ODI .
UNX - ODJ .
UOX - ODK .
UQX - OAG .
URX - OAO .
USX - OBG .
UTX - OBO .
UUX - OCG .
UWX - OCO .
UXX - ODG .
WAA - CAH .
WBA - CBH .
WCA - CCH .
WDA - CDH .
WEA - CEH .
WFA - CFH .
WGA - CGH .
WHA - CHH .
WIX - MAH .
WJX - MBH .
WKX - MCH .
WLX - MDH .
WMX - MEH .
WNX - MFH .
WOX - MGH .
WPX - MHH .
XQX - OAH .
XRX - OAP .
XSX - OBH .
XTX - OBP .  
XUX - OCH .
XVX - OCP .
XWX - ODH .        
