*
* Connector Definitions
* Module: JB
* Description: Main Issue (CPU issue logic that could not fit on JA)
* Revision: 
* Date: 
*
ZAA ZAB - OKA .
ZAC ZAD - ODA .
ZAE ZAF - ODI .
ZAG ZAH - IBI .
ZAI ZAJ - OHI .
ZAK ZAL - OHA .
ZAM ZAN - ICA .
ZAO ZAP - OAA .
ZAQ ZAR - OEA .
ZAS ZAT - ICI .
ZAU ZAV - OEI .
ZAW ZAX - OAI .
ZBA ZBB - OIA .
ZBC ZBD - IDA .
ZBE ZBF - IBA .
ZBG ZBH - OBA .
ZBI ZBJ - OFA .
ZBK ZBL - IKA .
ZBM ZBN - OFI .
ZBO ZBP - OBI .
ZBQ ZBR - OLA .
ZBS ZBT - OMA .
ZBU ZBV - ONA .
ZBW ZBX - IHA .
ZCA ZCB - OCA .
ZCC ZCD - OCI .
ZCE ZCF - IAI .
ZCG ZCH - OGI .
ZCI ZCJ - IAA .
ZCK ZCL - OGA .
ZCM ZCN - OSA .
ZCO ZCP - *** .
ZCQ ZCR - *** .
ZCS ZCT - *** .
ZCU ZCV - *** .
ZCW ZCX - *** .
 
ZDA ZDB - ICB .
ZDC ZDD - OAB .
ZDE ZDF - OEB .
ZDG ZDH - OEJ .
ZDI ZDJ - ICJ .
ZDK ZDL - OAJ .
ZDM ZDN - OIB .
ZDO ZDP - IDB .
ZDQ ZDR - OBB .
ZDS ZDT - OFB .
ZDU ZDV - IKB .
ZDW ZDX - OFJ .
ZEA ZEB - OBJ .
ZEC ZED - ONB .
ZEE ZEF - OLB .
ZEG ZEH - OMB .
ZEI ZEJ - IJA .
ZEK ZEL - OKB .
ZEM ZEN - OCB .
ZEO ZEP - OCJ .
ZEQ ZER - OGJ .
ZES ZET - IAB .
ZEU ZEV - OGB .
ZEW ZEX - IAJ .
ZFA ZFB - OSB .
ZFC ZFD - ODB .
ZFE ZFF - ODJ .
ZFG ZFH - IBJ .
ZFI ZFJ - OHJ .
ZFK ZFL - IBB .
ZFM ZFN - OHB .
ZFO ZFP - IGA .
ZFQ ZFR - IHB .
ZFS ZFT - *** .
ZFU ZFV - *** .
ZFW ZFX - *** .
 
ZGA ZGB - ICC .
ZGC ZGD - OAC .
ZGE ZGF - OEC .
ZGG ZGH - ICK .
ZGI ZGJ - OEK .
ZGK ZGL - OAK .
ZGM ZGN - OIC .
ZGO ZGP - IDC .
ZGQ ZGR - OBC .
ZGS ZGT - OFC .
ZGU ZGV - IKC .
ZGW ZGX - OFK .
ZHA ZHB - OBK .
ZHC ZHD - OLC .
ZHE ZHF - OMC .
ZHG ZHH - ONC .
ZHI ZHJ - OCC .
ZHK ZHL - OCK .
ZHM ZHN - OGK .
ZHO ZHP - IAC .
ZHQ ZHR - OGC .
ZHS ZHT - IAK .
ZHU ZHV - OSC .
ZHW ZHX - ODC .
ZIA ZIB - ODK .
ZIC ZID - OHK .
ZIE ZIF - IBC .
ZIG ZIH - OHC .
ZII ZIJ - IBK .
ZIK ZIL - ***.
ZIM ZIN - *** .
ZIO ZIP - IKD .
ZIQ ZIR - *** .
ZIS ZIT - *** .
ZIU ZIV - *** .
ZIW ZIX - *** .
 
ZJA ZJB - ICD .
ZJC ZJD - ICL .
ZJE ZJF - OAD .
ZJG ZJH - OED .
ZJI ZJJ - OEL .
ZJK ZJL - OAL .
ZJM ZJN - OID .
ZJO ZJP - IDD .
ZJQ ZJR - OBD .
ZJS ZJT - OFD .
ZJU ZJV - *** .
ZJW ZJX - OFL .
ZKA ZKB - OUA .
ZKC ZKD - OUC .
ZKE ZKF - OBL .
ZKG ZKH - OLD .
ZKI ZKJ - OMD .
ZKK ZKL - OND .
ZKM ZKN - OCD .
ZKO ZKP - OCL .
ZKQ ZKR - IAL .
ZKS ZKT - OGL .
ZKU ZKV - IAD .
ZKW ZKX - OGD .
ZLA ZLB - OSD .
ZLC ZLD - ODD .
ZLE ZLF - ODL .
ZLG ZLH - OHL .
ZLI ZLJ - IBD .
ZLK ZLL - OHD .
ZLM ZLN - IBL .
ZLO ZLP - ILA .
ZLQ ZLR - *** .
ZLS ZLT - *** .
ZLU ZLV - *** .
ZLW ZLX - *** .
 
ZMA ZMB - ICE .
ZMC ZMD - ICM .
ZME ZMF - OAE .
ZMG ZMH - OEE .
ZMI ZMJ - OEM .
ZMK ZML - OLF .
ZMM ZMN - OMF .
ZMO ZMP - OAM .
ZMQ ZMR - OIE .
ZMS ZMT - IDE .
ZMU ZMV - ONE .
ZMW ZMX - OBE .
ZNA ZNB - OFE .
ZNC ZND - IKE .
ZNE ZNF - OFM .
ZNG ZNH - OBM .
ZNI ZNJ - ORC .
ZNK ZNL - ORD .
ZNM ZNN - OUB .
ZNO ZNP - OCE .
ZNQ ZNR - OCM .
ZNS ZNT - OGM .
ZNU ZNV - IAE .
ZNW ZNX - OGE .
ZOA ZOB - IAM .
ZOC ZOD - OSE .
ZOE ZOF - OKC .
ZOG ZOH - OKE .
ZOI ZOJ - ODE .
ZOK ZOL - ODM .
ZOM ZON - IBM .
ZOO ZOP - OHM .
ZOQ ZOR - IBE .
ZOS ZOT - OHE .
ZOU ZOV - *** .
ZOW ZOX - *** .
 
ZPA ZPB - ICN .
ZPC ZPD - ICF .
ZPE ZPF - OAF .
ZPG ZPH - OEF .
ZPI ZPJ - OEN .
ZPK ZPL - OAN .
ZPM ZPN - OIF .
ZPO ZPP - IDF .
ZPQ ZPR - OBF .
ZPS ZPT - OFF .
ZPU ZPV - IKF .
ZPW ZPX - OFN .
ZQA ZQB - OBN .
ZQC ZQD - ONF .
ZQE ZQF - OJA .
ZQG ZQH - OJB .
ZQI ZQJ - OJL .
ZQK ZQL - ORA .
ZQM ZQN - ORB .
ZQO ZQP - OCF .
ZQQ ZQR - OCN .
ZQS ZQT - OGN .
ZQU ZQV - IAF .
ZQW ZQX - OGF .
ZRA ZRB - IAN .
ZRC ZRD - OSF .
ZRE ZRF - OKF .
ZRG ZRH - ODF .
ZRI ZRJ - ODN .
ZRK ZRL - OHN .
ZRM ZRN - IBF .
ZRO ZRP - OHF .
ZRQ ZRR - IBN .
ZRS ZRT - *** .
ZRU ZRV - *** .
ZRW ZRX - *** .
 
ZSA ZSB - ODG .
ZSC ZSD - ODO .
ZSE ZSF - OHO .
ZSG ZSH - IBG .
ZSI ZSJ - OHG .
ZSK ZSL - IBO .
ZSM ZSN - ICG .
ZSO ZSP - ICO .
ZSQ ZSR - OAG .
ZSS ZST - OEG .
ZSU ZSV - OEO .
ZSW ZSX - OJJ .
ZTA ZTB - OJK .
ZTC ZTD - OAO .
ZTE ZTF - OIG .
ZTG ZTH - OBG .
ZTI ZTJ - OFG .
ZTK ZTL - IKG .
ZTM ZTN - OFO .
ZTO ZTP - OBO .
ZTQ ZTR - OJI .
ZTS ZTT - OJF .
ZTU ZTV - OJG .
ZTW ZTX - OJH .
ZUA ZUB - IFA .
ZUC ZUD - OCG .
ZUE ZUF - OCO .
ZUG ZUH - OGO .
ZUI ZUJ - IAG .
ZUK ZUL - OGG .
ZUM ZUN - IAO .
ZUO ZUP - OKD .
ZUQ ZUR - OSG .
ZUS ZUT - *** .
ZUU ZUV - *** .
ZUW ZUX - *** .
 
ZVA ZVB - ODH .
ZVC ZVD - ODP .
ZVE ZVF - OHP .
ZVG ZVH - IBH .
ZVI ZVJ - OHH .
ZVK ZVL - IBP .
ZVM ZVN - OSH .
ZVO ZVP - ICP .
ZVQ ZVR - ICH .
ZVS ZVT - OAH .
ZVU ZVV - OEH .
ZVW ZVX - OEP .
ZWA ZWB - OIH .
ZWC ZWD - IHF .
ZWE ZWF - OAP .
ZWG ZWH - OJD .
ZWI ZWJ - OJE .
ZWK ZWL - OJC .
ZWM ZWN - ILA .
ZWO ZWP - OBH .
ZWQ ZWR - OFH .
ZWS ZWT - IKH .
ZWU ZWV - OFP .
ZWW ZWX - *** .
ZXA ZXB - OBP .
ZXC ZXD - OTA .
ZXE ZXF - IGA .
ZXG ZXH - IEA .
ZXI ZXJ - IEB .
ZXK ZXL - OCH .
ZXM ZXN - OCP .
ZXO ZXP - OGP .
ZXQ ZXR - IAH .
ZXS ZXT - OGH .
ZXU ZXV - IAP .
ZXW ZXX - *** .                     
