*
* Connector Definitions
* Module: TC
* Description: Memory interface modules, packetize address and data, SECDED
* Revision:
* Date: 
* 
ZAA ZAB - IAA .
ZAC ZAD - IAB .
ZAE ZAF - IAC .
ZAG ZAH - IAD .
ZAI ZAJ - IAE .
ZAK ZAL - IAF .
ZAM ZAN - IAG .
ZAO ZAP - IAH .
ZAQ ZAR - IAI .
ZAS ZAT - IAJ .
ZAU ZAV - IAK .
ZAW ZAX - IAL .
ZBA ZBB - IAM .
ZBC ZBD - IAN .
ZBE ZBF - IAO .
ZBG ZBH - IAP .
ZBI ZBJ - IAQ .
ZBK ZBL - IAR .
ZBM ZBN - IAS .
ZBO ZBP - IAT .
ZBQ ZBR - IAU .
ZBS ZBT - IAV .
ZBU ZBV - IAW .
ZBW ZBX - IAX .
ZCA ZCB - IBA .
ZCC ZCD - IBB .
ZCE ZCF - IBC .
ZCG ZCH - IBD .
ZCI ZCJ - IBE .
ZCK ZCL - IBF .
ZCM ZCN - IBG .
ZCO ZCP - IBH .
ZCQ ZCR - IBI .
ZCS ZCT - IBJ .
ZCU ZCV - IBK .
ZCW ZCX - IBL .
       	 
ZDA ZDB - IBM .
ZDC ZDD - IBN .
ZDE ZDF - IBO .
ZDG ZDH - IBP .
ZDI ZDJ - IBQ .
ZDK ZDL - IBR .
ZDM ZDN - IBS .
ZDO ZDP - IBT .
ZDQ ZDR - IBU .
ZDS ZDT - IBV .
ZDU ZDV - IBW .
ZDW ZDX - IBX .
ZEA ZEB - ICA .
ZEC ZED - ICB .
ZEE ZEF - ICC .
ZEG ZEH - ICD .
ZEI ZEJ - ICE .
ZEK ZEL - ICF .
ZEM ZEN - ICG .
ZEO ZEP - ICH .
ZEQ ZER - ICI .
ZES ZET - ICJ .
ZEU ZEV - ICK .
ZEW ZEX - ICL .
ZFA ZFB - ICM .
ZFC ZFD - ICN .
ZFE ZFF - ICO .
ZFG ZFH - ICP .
ZFI ZFJ - ICQ .
ZFK ZFL - ICR .
ZFM ZFN - ICS .
ZFO ZFP - ICT .
ZFQ ZFR - ICU .
ZFS ZFT - ICV .
ZFU ZFV - ICW .
ZFW ZFX - ICX .
       
ZGA ZGB - IDA .
ZGC ZGD - IDB .
ZGE ZGF - IDC .
ZGG ZGH - IDD .
ZGI ZGJ - IDE .
ZGK ZGL - IDF .
ZGM ZGN - IDG .
ZGO ZGP - IDH .
ZGQ ZGR - IDI .
ZGS ZGT - IDJ .
ZGU ZGV - IDK .
ZGW ZGX - IDL .
ZHA ZHB - IDM .
ZHC ZHD - IDN .
ZHE ZHF - IDO .
ZHG ZHH - IDP .
ZHI ZHJ - IDQ .
ZHK ZHL - IDR .
ZHM ZHN - IDS .
ZHO ZHP - IDT .
ZHQ ZHR - IDU .
ZHS ZHT - IDV .
ZHU ZHV - IDW .
ZHW ZHX - IDX .
ZIA ZIB - IEA .
ZIC ZID - IEB .
ZIE ZIF - IEC .
ZIG ZIH - IED .
ZII ZIJ - IEE .
ZIK ZIL - IEF .
ZIM ZIN - IEG .
ZIO ZIP - IEH .
ZIQ ZIR - IEI .
ZIS ZIT - IEJ .
ZIU ZIV - IEK .
ZIW ZIX - IEL .
       
ZJA ZJB - IEM .
ZJC ZJD - IEN .
ZJE ZJF - IEO .
ZJG ZJH - IEP .
ZJI ZJJ - IEQ .
ZJK ZJL - IER .
ZJM ZJN - IES .
ZJO ZJP - IET .
ZJQ ZJR - IEU .
ZJS ZJT - IEV .
ZJU ZJV - IEW .
ZJW ZJX - IEX .
ZKA ZKB - IFA .
ZKC ZKD - IGA .
ZKE ZKF - IGB .
ZKG ZKH - IGC .
ZKI ZKJ - IHA .
ZKK ZKL - IHD .
ZKM ZKN - OAA .
ZKO ZKP - OAB .
ZKQ ZKR - OAC .
ZKS ZKT - OAD .
ZKU ZKV - OAE .
ZKW ZKX - OAF .
ZLA ZLB - OAG .
ZLC ZLD - OAH .
ZLE ZLF - OAI .
ZLG ZLH - OAJ .
ZLI ZLJ - OAK .
ZLK ZLL - OAL .
ZLM ZLN - OAM .
ZLO ZLP - OAN .
ZLQ ZLR - OAO .
ZLS ZLT - OAP .
ZLU ZLV - OAQ .
ZLW ZLX - OAR .
       
ZMA ZMB - OAS .
ZMC ZMD - OAT .
ZME ZMF - OAU .
ZMG ZMH - OAV .
ZMI ZMJ - OAW .
ZMK ZML - OAX .
ZMM ZMN - OBA .
ZMO ZMP - OBB .
ZMQ ZMR - OBC .
ZMS ZMT - OBD .
ZMU ZMV - OBE .
ZMW ZMX - OBF .
ZNA ZNB - OBG .
ZNC ZND - OBH .
ZNE ZNF - OBI .
ZNG ZNH - OBJ .
ZNI ZNJ - OBK .
ZNK ZNL - OBL .
ZNM ZNN - OBM .
ZNO ZNP - OBN .
ZNQ ZNR - OBO .
ZNS ZNT - OBP .
ZNU ZNV - OBQ .
ZNW ZNX - OBR .
ZOA ZOB - OBS .
ZOC ZOD - OBT .
ZOE ZOF - OBU .
ZOG ZOH - OBV .
ZOI ZOJ - OBW .
ZOK ZOL - OBX .
ZOM ZON - OCA .
ZOO ZOP - OCB .
ZOQ ZOR - OCC .
ZOS ZOT - OCD .
ZOU ZOV - OCE .
ZOW ZOX - OCF .
       
ZPA ZPB - OCG .
ZPC ZPD - OCH .
ZPE ZPF - OCI .
ZPG ZPH - OCJ .
ZPI ZPJ - OCK .
ZPK ZPL - OCL .
ZPM ZPN - OCM .
ZPO ZPP - OCN .
ZPQ ZPR - OCO .
ZPS ZPT - OCP .
ZPU ZPV - OCQ .
ZPW ZPX - OCR .
ZQA ZQB - OCS .
ZQC ZQD - OCT .
ZQE ZQF - OCU .
ZQG ZQH - OCV .
ZQI ZQJ - OCW .
ZQK ZQL - OCX .
ZQM ZQN - ODA .
ZQO ZQP - ODB .
ZQQ ZQR - ODC .
ZQS ZQT - ODD .
ZQU ZQV - ODE .
ZQW ZQX - ODF .
ZRA ZRB - ODG .
ZRC ZRD - ODH .
ZRE ZRF - ODI .
ZRG ZRH - ODJ .
ZRI ZRJ - ODK .
ZRK ZRL - ODL .
ZRM ZRN - ODM .
ZRO ZRP - ODN .
ZRQ ZRR - ODO .
ZRS ZRT - ODP .
ZRU ZRV - ODQ .
ZRW ZRX - ODR .
     
ZSA ZSB - ODS .
ZSC ZSD - ODT .
ZSE ZSF - ODU .
ZSG ZSH - ODV .
ZSI ZSJ - ODW .
ZSK ZSL - ODX .
ZSM ZSN - IHC .
ZSO ZSP - IFB .
ZSQ ZSR - IFC .
ZSS ZST - IFD .
ZSU ZSV - IGD .
ZSW ZSX - IGE .
ZTC ZTD - IGF .
ZTE ZTF - IGG .
ZTG ZTH - IGH .
ZTI ZTJ - *** .
ZTK ZTL - *** .
ZTM ZTN - *** .
ZTO ZTP - *** .
ZTQ ZTR - *** .
ZTS ZTT - *** .
ZTU ZTV - *** .
ZTW ZTX - *** .
ZUA ZUB - *** .
ZUC ZUD - *** .
ZUE ZUF - *** .
ZUG ZUH - *** .
ZUI ZUJ - *** .
ZUK ZUL - *** .
ZUM ZUN - *** .
ZUO ZUP - *** .
ZUQ ZUR - *** .
ZUS ZUT - *** .
ZUU ZUV - *** .
ZUW ZUX - *** .
     
ZVA ZVB - *** .
ZVC ZVD - *** .
ZVE ZVF - *** .
ZVG ZVH - *** .
ZVI ZVJ - *** .
ZVK ZVL - *** .
ZVM ZVN - *** .
ZVO ZVP - *** .
ZVQ ZVR - *** .
ZVS ZVT - *** .
ZVU ZVV - *** .
ZVW ZVX - *** .
ZWA ZWB - *** .
ZWC ZWD - *** .
ZWE ZWF - *** .
ZWG ZWH - *** .
ZWI ZWJ - *** .
ZWK ZWL - *** .
ZWM ZWN - *** .
ZWO ZWP - *** .
ZWQ ZWR - *** .
ZWS ZWT - *** .
ZWU ZWV - *** .
ZWW ZWX - *** .
ZXA ZXB - *** .
ZXC ZXD - *** .
ZXE ZXF - *** .
ZXG ZXH - *** .
ZXI ZXJ - *** .
ZXK ZXL - *** .
ZXM ZXN - *** .
ZXO ZXP - *** .
ZXQ ZXR - *** .
ZXS ZXT - *** .
ZXU ZXV - *** .
ZXW ZXX - *** . 
