*
* Package Definitions
* Module: TC
* Description: Memory interface modules, packetize address and data, SECDED
* Revision:
* Date: 
* 
A1L - NAA NAB NAC NAD .
A2L - PAA PAE PAF PBA .
A3L - PBE PBF PCA PCE .
A4L - PCF PDA PDE PDF .
A5J - TAA TAB TBA TCA .
A6J - TEA TFA .
A7J - TBB TCB .
AAL - EGA EGB EGC EGD .
ABL - EGE EGF EGG EGH .
ACL - EGI EGJ EGK EGL .
ADL - EGM EGN EGO EGP .
AEL - EGQ EGR EGS EGT .
AFL - EGU EGV EGW EGX .
AGL - FGA FGB FGC FGD .
AHL - FGE FGF FGG FGH .
AIL - FGI FGJ FGK FGL .
AJL - FGM FGN FGO FGP .
AKL - FGQ FGR FGS FGT .
ALL - FGU FGV FGW FGX .
AML - GGA GGB GGC GGD .
ANL - GGE GGF GGG GGH .
AOL - GGI GGJ GGK GGL .
APL - GGM GGN GGO GGP .
AQL - GGQ GGR GGS GGT .
ARL - GGU GGV GGW GGX .
ASL - HGA HGB HGC HGD .
ATL - HGE HGF HGG HGH .
AUL - HGI HGJ HGK HGL .
AVL - HGM HGN HGO HGP .
AWL - HGQ HGR HGS HGT .
AXL - HGU HGV HGW HGX .
B1O - GEA GEB GEC .
B2O - GFA GFB GFC .
B3O - HAA HAB HAC .
B4O - HBA HBB HBC .
B5O - HCA HCB HCC .
B6O - HDA HDB HDC .
B7O - HEA HEB HEC .
B8O - HFA HFB HFC .
BAO - AAA AAB AAC .
BBO - BAA BAB BAC .
BCO - ABA ABB ABC .
BDO - BBA BBB BBC .
BEO - ACA ACB ACC .
BFO - BCA BCB BCC .
BGO - ADA ADB ADC .
BHO - BDA BDB BDC .
BIO - EAA EAB EAC .
BJO - EBA EBB EBC .
BKO - ECA ECB ECC .
BLO - EDA EDB EDC .
BMO - EEA EEB EEC .
BNO - EFA EFB EFC .
BOO - FAA FAB FAC .
BPO - FBA FBB FBC .
BQO - FCA FCB FCC .
BRO - FDA FDB FDC .
BSO - FEA FEB FEC .
BTO - FFA FFB FFC .
BUO - GAA GAB GAC .
BVO - GBA GBB GBC .
BWO - GCA GCB GCC .
BXO - GDA GDB GDC .
C1J - TGA .
C2J - TGB .
C3J - TGC .
C4J - THA .
C5J - THB .
C6J - THC .
C7J - THE .
C8J - THF .
CAJ - TGD .
CBJ - TGE TGF TGG TGH .
CCJ - THD .
CDJ - THG *** THH .
CEJ - TAD TBD TED TFD .
CFJ - TBC TCC TFC TEC .
CGJ - TEB TFB TAC TCD .
CHL - QAA QAB QAC QAD .
CIM - QBA .
CJI - JBA .
CKK - JAA .
CLP - QEG .
CMM - QEJ QEK .
CNP - QEI .
COP - QEP .
CPP - QEV QEW .
CQM - QEU .
CRP - QEH .
CSM - QEA .
CUM - QED .
CVM - QEE .
CWM - QEB .
DAM - OAA EHA .
DBM - OAH EHH .
DCM - OAO EHO .
DDM - OAV EHV .
DEM - OBE FHE .
DFM - OBL FHL .
DGM - OBS FHS .
DHM - OCB GHB .
DIM - OCI GHI .
DJM - OCP GHP .
DKM - OCW GHW .
DLM - ODF HHF .
DMM - ODM HHM .
DNM - ODT HHT .
DOM - QBB .
DPM - QBC .
DQM - QBD .
E1O - GED GEE GEF .
E2O - GFD GFE GFF .
E3O - HAD HAE HAF .
E4O - HBD HBE HBF .
E5O - HCD HCE HCF .
E6O - HDD HDE HDF .
E7O - HED HEE HEF .
E8O - HFD HFE HFF .
EAO - AAD AAE AAF .
EBO - BAD BAE BAF .
ECO - ABD ABE ABF .
EDO - BBD BBE BBF .
EEO - ACD ACE ACF .
EFO - BCD BCE BCF .
EGO - ADD ADE ADF .
EHO - BDD BDE BDF .
EIO - EAD EAE EAF .
EJO - EBD EBE EBF .
EKO - ECD ECE ECF .
ELO - EDD EDE EDF .
EMO - EED EEE EEF .
ENO - EFD EFE EFF .
EOO - FAD FAE FAF .
EPO - FBD FBE FBF .
EQO - FCD FCE FCF .
ERO - FDD FDE FDF .
ESO - FED FEE FEF .
ETO - FFD FFE FFF .
EUO - GAD GAE GAF .
EVO - GBD GBE GBF .
EWO - GCD GCE GCF .
EXO - GDD GDE GDF .
FBM - QES QET .
FDM - QEM QEN .
FEJ - TKA TKB TKC TKD .
FFJ - TKE TKF .
FGJ - TLA TLB TLC TLD .
FHJ - TLE TLF .
FIJ - TMA TMB TMC TMD .
FJJ - TME TMF .
FKJ - TNA TNB TNC TND .
FLJ - TNE TNF .
GAM - OAB EHB  .
GBM - OAI EHI  .
GCM - OAP EHP  .
GDM - OAW EHW  .
GEM - OBF FHF  .
GFM - OBM FHM  .
GGM - OBT FHT  .
GHM - OCC GHC  .
GIM - OCJ GHJ  .
GJM - OCQ GHQ  .
GKM - OCX GHX  .
GLM - ODG HHG  .
GMM - ODN HHN  .
GNM - ODU HHU  .
H1O - GEG GEH GEI .
H2O - GFG GFH GFI .
H3O - HAG HAH HAI .
H4O - HBG HBH HBI .
H5O - HCG HCH HCI .
H6O - HDG HDH HDI .
H7O - HEG HEH HEI .
H8O - HFG HFH HFI .
HAO - AAG AAH AAI .
HBO - BAG BAH BAI .
HCO - ABG ABH ABI .
HDO - BBG BBH BBI .
HEO - ACG ACH ACI .
HFO - BCG BCH BCI .
HGO - ADG ADH ADI .
HHO - BDG BDH BDI .
HIO - EAG EAH EAI .
HJO - EBG EBH EBI .
HKO - ECG ECH ECI .
HLO - EDG EDH EDI .
HMO - EEG EEH EEI .
HNO - EFG EFH EFI .
HOO - FAG FAH FAI .
HPO - FBG FBH FBI .
HQO - FCG FCH FCI .
HRO - FDG FDH FDI .
HSO - FEG FEH FEI .
HTO - FFG FFH FFI .
HUO - GAG GAH GAI .
HVO - GBG GBH GBI .
HWO - GCG GCH GCI .
HXO - GDG GDH GDI .
ILP - QFG .
IMM - QFJ QFK .
INP - QFI .
IOP - QFP .
IPP - QFV QFW .
IQM - QFU .
IRP - QFH .
ISM - QFA .
IUM - QFD .
IVM - QFE .
IWM - QFB .
JAM - OAC EHC  .
JBM - OAJ EHJ  .
JCM - OAQ EHQ  .
JDM - OAX EHX  .
JEM - OBG FHG  .
JFM - OBN FHN  .
JGM - OBU FHU  .
JHM - OCD GHD  .
JIM - OCK GHK  .
JJM - OCR GHR  .
JKM - ODA HHA  .
JLM - ODH HHH  .
JMM - ODO HHO  .
JNM - ODV HHV  .
K1O - GEJ GEK GEL .
K2O - GFJ GFK GFL .
K3O - HAJ HAK HAL .
K4O - HBJ HBK HBL .
K5O - HCJ HCK HCL .
K6O - HDJ HDK HDL .
K7O - HEJ HEK HEL .
K8O - HFJ HFK HFL .
KAO - AAJ AAK AAL .
KBO - BAJ BAK BAL .
KCO - ABJ ABK ABL .
KDO - BBJ BBK BBL .
KEO - ACJ ACK ACL .
KFO - BCJ BCK BCL .
KGO - ADJ ADK ADL .
KHO - BDJ BDK BDL .
KIO - EAJ EAK EAL .
KJO - EBJ EBK EBL .
KKO - ECJ ECK ECL .
KLO - EDJ EDK EDL .
KMO - EEJ EEK EEL .
KNO - EFJ EFK EFL .
KOO - FAJ FAK FAL .
KPO - FBJ FBK FBL .
KQO - FCJ FCK FCL .
KRO - FDJ FDK FDL .
KSO - FEJ FEK FEL .
KTO - FFJ FFK FFL .
KUO - GAJ GAK GAL .
KVO - GBJ GBK GBL .
KWO - GCJ GCK GCL .
KXO - GDJ GDK GDL .
LLP - QGG .
LMM - QGJ QGK .
LNP - QGI .
LOP - QGP .
LPP - QGV QGW .
LQM - QGU .
LRP - QGH .
LSM - QGA .
LUM - QGD .
LVM - QGE .
LWM - QGB .
MAM - OAD EHD  .
MBM - OAK EHK  .
MCM - OAR EHR  .
MDM - OBA FHA  .
MEM - OBH FHH  .
MFM - OBO FHO  .
MGM - OBV FHV  .
MHM - OCE GHE  .
MIM - OCL GHL  .
MJM - OCS GHS  .
MKM - ODB HHB  .
MLM - ODI HHI  .
MMM - ODP HHP  .
MNM - ODW HHW  .
N1O - GEM GEN GEO .
N2O - GFM GFN GFO .
N3O - HAM HAN HAO .
N4O - HBM HBN HBO .
N5O - HCM HCN HCO .
N6O - HDM HDN HDO .
N7O - HEM HEN HEO .
N8O - HFM HFN HFO .
NAO - AAM AAN AAO .
NBO - BAM BAN BAO .
NCO - ABM ABN ABO .
NDO - BBM BBN BBO .
NEO - ACM ACN ACO .
NFO - BCM BCN BCO .
NGO - ADM ADN ADO .
NHO - BDM BDN BDO .
NIO - EAM EAN EAO .
NJO - EBM EBN EBO .
NKO - ECM ECN ECO .
NLO - EDM EDN EDO .
NMO - EEM EEN EEO .
NNO - EFM EFN EFO .
NOO - FAM FAN FAO .
NPO - FBM FBN FBO .
NQO - FCM FCN FCO .
NRO - FDM FDN FDO .
NSO - FEM FEN FEO .
NTO - FFM FFN FFO .
NUO - GAM GAN GAO .
NVO - GBM GBN GBO .
NWO - GCM GCN GCO .
NXO - GDM GDN GDO .
O1M - QFS QFT .
O2M - QFM QFN .
O3M - QGS QGT .
O4M - QGM QGN .
O5M - QHS QHT .
O6M - QHM QHN .
OLP - QHG .
OMM - QHJ QHK .
ONP - QHI .
OOP - QHP .
OPP - QHV QHW .
OQM - QHU .
ORP - QHH .
OSM - QHA .
OUM - QHD .
OVM - QHE .
OWM - QHB .
PAM - OAE EHE  .
PBM - OAL EHL  .
PCM - OAS EHS  .
PDM - OBB FHB  .
PEM - OBI FHI  .
PFM - OBP FHP  .
PGM - OBW FHW  .
PHM - OCF GHF  .
PIM - OCM GHM  .
PJM - OCT GHT  .
PKM - ODC HHC  .
PLM - ODJ HHJ  .
PMM - ODQ HHQ  .
PNM - ODX HHX  .
Q1O - GEP GEQ GER .
Q2O - GFP GFQ GFR .
Q3O - HAP HAQ HAR .
Q4O - HBP HBQ HBR .
Q5O - HCP HCQ HCR .
Q6O - HDP HDQ HDR .
Q7O - HEP HEQ HER .
Q8O - HFP HFQ HFR .
QAO - AAP AAQ AAR .
QBO - BAP BAQ BAR .
QCO - ABP ABQ ABR .
QDO - BBP BBQ BBR .
QEO - ACP ACQ ACR .
QFO - BCP BCQ BCR .
QGO - ADP ADQ ADR .
QHO - BDP BDQ BDR .
QIO - EAP EAQ EAR .
QJO - EBP EBQ EBR .
QKO - ECP ECQ ECR .
QLO - EDP EDQ EDR .
QMO - EEP EEQ EER .
QNO - EFP EFQ EFR .
QOO - FAP FAQ FAR .
QPO - FBP FBQ FBR .
QQO - FCP FCQ FCR .
QRO - FDP FDQ FDR .
QSO - FEP FEQ FER .
QTO - FFP FFQ FFR .
QUO - GAP GAQ GAR .
QVO - GBP GBQ GBR .
QWO - GCP GCQ GCR .
QXO - GDP GDQ GDR .
SAM - OAF EHF  .
SBM - OAM EHM  .
SCM - OAT EHT  .
SDM - OBC FHC  .
SEM - OBJ FHJ  .
SFM - OBQ FHQ  .
SGM - OBX FHX  .
SHM - OCG GHG  .
SIM - OCN GHN  .
SJM - OCU GHU  .
SKM - ODD HHD  .
SLM - ODK HHK  .
SMM - ODR HHR  .
SNL - tda .
SOL - tdb .
SPL - tdc .
SQL - tdd .
T1O - GES GET GEU .
T2O - GFS GFT GFU .
T3O - HAS HAT HAU .
T4O - HBS HBT HBU .
T5O - HCS HCT HCU .
T6O - HDS HDT HDU .
T7O - HES HET HEU .
T8O - HFS HFT HFU .
TAO - AAS AAT AAU .
TBO - BAS BAT BAU .
TCO - ABS ABT ABU .
TDO - BBS BBT BBU .
TEO - ACS ACT ACU .
TFO - BCS BCT BCU .
TGO - ADS ADT ADU .
THO - BDS BDT BDU .
TIO - EAS EAT EAU .
TJO - EBS EBT EBU .
TKO - ECS ECT ECU .
TLO - EDS EDT EDU .
TMO - EES EET EEU .
TNO - EFS EFT EFU .
TOO - FAS FAT FAU .
TPO - FBS FBT FBU .
TQO - FCS FCT FCU .
TRO - FDS FDT FDU .
TSO - FES FET FEU .
TTO - FFS FFT FFU .
TUO - GAS GAT GAU .
TVO - GBS GBT GBU .
TWO - GCS GCT GCU .
TXO - GDS GDT GDU .
VAM - OAG EHG  .
VBM - OAN EHN  .
VCM - OAU EHU  .
VDM - OBD FHD  .
VEM - OBK FHK  .
VFM - OBR FHR  .
VGM - OCA GHA  .
VHM - OCH GHH  .
VIM - OCO GHO  .
VJM - OCV GHV  .
VKM - ODE HHE  .
VLM - ODL HHL  .
VMM - ODS HHS  .
W1O - GEV GEW GEX .
W2O - GFV GFW GFX .
W3O - HAV HAW HAX .
W4O - HBV HBW HBX .
W5O - HCV HCW HCX .
W6O - HDV HDW HDX .
W7O - HEV HEW HEX .
W8O - HFV HFW HFX .
WAO - AAV AAW AAX .
WBO - BAV BAW BAX .
WCO - ABV ABW ABX .
WDO - BBV BBW BBX .
WEO - ACV ACW ACX .
WFO - BCV BCW BCX .
WGO - ADV ADW ADX .
WHO - BDV BDW BDX .
WIO - EAV EAW EAX .
WJO - EBV EBW EBX .
WKO - ECV ECW ECX .
WLO - EDV EDW EDX .
WMO - EEV EEW EEX .
WNO - EFV EFW EFX .
WOO - FAV FAW FAX .
WPO - FBV FBW FBX .
WQO - FCV FCW FCX .
WRO - FDV FDW FDX .
WSO - FEV FEW FEX .
WTO - FFV FFW FFX .
WUO - GAV GAW GAX .
WVO - GBV GBW GBX .
WWO - GCV GCW GCX .
WXO - GDV GDW GDX .
