*
* Connector Definitions
* Module: KB
* Description: Foreground CPU
* Revision: 
* Date: 
*
ZAA ZAB - OEA .
ZAC ZAD - OEI .
ZAE ZAF - OFA .
ZAG ZAH - OFI .
ZAI ZAJ - ODA .
ZAK ZAL - ODI .
ZAM ZAN - OAA .
ZAO ZAP - OAI .
ZAQ ZAR - OBA .
ZAS ZAT - OBI .
ZAU ZAV - OAS .
ZAW ZAX - OAQ .
ZBA ZBB - OAR .
ZBC ZBD - OAT .
ZBE ZBF - OCA .
ZBG ZBH - OCI .
ZBI ZBJ - IFI .
ZBK ZBL - IEA .
ZBM ZBN - IEI .
ZBO ZBP - IHL .
ZBQ ZBR - IFA .
ZBS ZBT - IDA .
ZBU ZBV - IDI .
ZBW ZBX - IAA .
ZCA ZCB - IAI .
ZCC ZCD - IGA .
ZCE ZCF - IGI .
ZCG ZCH - IBA .
ZCI ZCJ - IBI .
ZCK ZCL - *** .
ZCM ZCN - *** .
ZCO ZCP - IHC .
ZCQ ZCR - ICA .
ZCS ZCT - ICI .
ZCU ZCV - IHD .
ZCW ZCX - *** .

ZDA ZDB - OEB .
ZDC ZDD - OEJ .
ZDE ZDF - OFB .
ZDG ZDH - OFJ .
ZDI ZDJ - ODB .
ZDK ZDL - ODJ .
ZDM ZDN - OAB .
ZDO ZDP - OAJ .
ZDQ ZDR - OBB .
ZDS ZDT - OBJ .
ZDU ZDV - OBS .
ZDW ZDX - OBQ .
ZEA ZEB - OBR .
ZEC ZED - OBT .
ZEE ZEF - OCB .
ZEG ZEH - OCJ .
ZEI ZEJ - IFJ .
ZEK ZEL - IEB .
ZEM ZEN - IEJ .
ZEO ZEP - IFB .
ZEQ ZER - IDB .
ZES ZET - IDJ .
ZEU ZEV - IAB .
ZEW ZEX - IAJ .
ZFA ZFB - IGB .
ZFC ZFD - IGJ .
ZFE ZFF - IBB .
ZFG ZFH - IBJ .
ZFI ZFJ - ICB .
ZFK ZFL - ICJ .
ZFM ZFN - *** .
ZFO ZFP - *** .
ZFQ ZFR - *** .
ZFS ZFT - *** .
ZFU ZFV - *** .
ZFW ZFX - *** .
 
ZGA ZGB - OEC .
ZGC ZGD - OEK .
ZGE ZGF - OFD .
ZGG ZGH - OFL .
ZGI ZGJ - ODC .
ZGK ZGL - ODK .
ZGM ZGN - OAC .
ZGO ZGP - OAK .
ZGQ ZGR - OBC .
ZGS ZGT - OBK .
ZGU ZGV - OCS .
ZGW ZGX - OCQ .
ZHA ZHB - OCR .
ZHC ZHD - OCT .
ZHE ZHF - OCC .
ZHG ZHH - OCK .
ZHI ZHJ - IFK .
ZHK ZHL - IEC .
ZHM ZHN - IEK .
ZHO ZHP - IFC .
ZHQ ZHR - IDC .
ZHS ZHT - IDK .
ZHU ZHV - IAC .
ZHW ZHX - IAK .
ZIA ZIB - IGC .
ZIC ZID - IGK .
ZIE ZIF - IBC .
ZIG ZIH - IBK .
ZII ZIJ - ICC .
ZIK ZIL - ICK .
ZIM ZIN - *** .
ZIO ZIP - *** .
ZIQ ZIR - *** .
ZIS ZIT - *** .
ZIU ZIV - *** .
ZIW ZIX - *** .
 
ZJA ZJB - OED .
ZJC ZJD - OEL .
ZJE ZJF - OFC .
ZJG ZJH - OFK .
ZJI ZJJ - ODD .
ZJK ZJL - ODL .
ZJM ZJN - OAD .
ZJO ZJP - OAL .
ZJQ ZJR - OBD .
ZJS ZJT - OBL .
ZJU ZJV - ODS .
ZJW ZJX - ODQ .
ZKA ZKB - ODR .
ZKC ZKD - ODT .
ZKE ZKF - OCD .
ZKG ZKH - OCL .
ZKI ZKJ - IFL .
ZKK ZKL - IED .
ZKM ZKN - IEL .
ZKO ZKP - IFD .
ZKQ ZKR - IDT .
ZKS ZKT - IDD .
ZKU ZKV - IDL .
ZKW ZKX - IAD .
ZLA ZLB - IAL .
ZLC ZLD - IGD .
ZLE ZLF - IGL .
ZLG ZLH - IBD .
ZLI ZLJ - IBL .
ZLK ZLL - ICD .
ZLM ZLN - ICL .
ZLO ZLP - *** .
ZLQ ZLR - *** .
ZLS ZLT - *** .
ZLU ZLV - *** .
ZLW ZLX - *** .
 
ZMA ZMB - OEE .
ZMC ZMD - OEM .
ZME ZMF - OFE .
ZMG ZMH - OFM .
ZMI ZMJ - ODE .
ZMK ZML - ODM .
ZMM ZMN - OAE .
ZMO ZMP - OAM .
ZMQ ZMR - OBE .
ZMS ZMT - OBM .
ZMU ZMV - OCE .
ZMW ZMX - OFF .
ZNA ZNB - OFN .
ZNC ZND - OCM .
ZNE ZNF - IFM .
ZNG ZNH - IEE .
ZNI ZNJ - IEM .
ZNK ZNL - IFE .
ZNM ZNN - IDE .
ZNO ZNP - IDM .
ZNQ ZNR - IAE .
ZNS ZNT - IAM .
ZNU ZNV - IGE .
ZNW ZNX - IBE .
ZOA ZOB - IBM .
ZOC ZOD - IHA .
ZOE ZOF - IHB .
ZOG ZOH - IHE .
ZOI ZOJ - ICE .
ZOK ZOL - ICM .
ZOM ZON - *** .
ZOO ZOP - *** .
ZOQ ZOR - *** .
ZOS ZOT - *** .
ZOU ZOV - *** .
ZOW ZOX - *** .
 
ZPA ZPB - OEF .
ZPC ZPD - OEN .
ZPE ZPF - ODF .
ZPG ZPH - ODN .
ZPI ZPJ - OAF .
ZPK ZPL - OAN .
ZPM ZPN - OBF .
ZPO ZPP - OBN .
ZPQ ZPR - OHA .
ZPS ZPT - OCF .
ZPU ZPV - OCN .
ZPW ZPX - IFN .
ZQA ZQB - IEF .
ZQC ZQD - IEN .
ZQE ZQF - IHG .
ZQG ZQH - IHH .
ZQI ZQJ - IFF .
ZQK ZQL - IDF .
ZQM ZQN - IDN .
ZQO ZQP - IAF .
ZQQ ZQR - IAN .
ZQS ZQT - IGF .
ZQU ZQV - IBF .
ZQW ZQX - IBN .
ZRA ZRB - IHI .
ZRC ZRD - IHJ .
ZRE ZRF - IHK .
ZRG ZRH - ICF .
ZRI ZRJ - ICN .
ZRK ZRL - *** .
ZRM ZRN - *** .
ZRO ZRP - *** .
ZRQ ZRR - *** .
ZRS ZRT - *** .
ZRU ZRV - *** .
ZRW ZRX - *** .
 
ZSA ZSB - OEG .
ZSC ZSD - OEO .
ZSE ZSF - OFG .
ZSG ZSH - OFO .
ZSI ZSJ - ODG .
ZSK ZSL - ODO .
ZSM ZSN - OAG .
ZSO ZSP - OAO .
ZSQ ZSR - OBG .
ZSS ZST - OBO .
ZSU ZSV - OGA .
ZSW ZSX - OGB .
ZTA ZTB - OCG .
ZTC ZTD - OCO .
ZTE ZTF - *** .
ZTG ZTH - IEG .
ZTI ZTJ - IEO .
ZTK ZTL - IHF .
ZTM ZTN - IFG .
ZTO ZTP - IFO .
ZTQ ZTR - IDG .
ZTS ZTT - IDO .
ZTU ZTV - IAG .
ZTW ZTX - IAO .
ZUA ZUB - IGG .
ZUC ZUD - IBG .
ZUE ZUF - IBO .
ZUG ZUH - IAQ .
ZUI ZUJ - IAT .
ZUK ZUL - IBT .
ZUM ZUN - ICG .
ZUO ZUP - ICO .
ZUQ ZUR - IAS .
ZUS ZUT - IBS .
ZUU ZUV - IBQ .
ZUW ZUX - *** .

ZVA ZVB - OEH .
ZVC ZVD - OEP .
ZVE ZVF - OFH .
ZVG ZVH - OFP .
ZVI ZVJ - ODH .
ZVK ZVL - ODP .
ZVM ZVN - OAH .
ZVO ZVP - OAP .
ZVQ ZVR - OBH .
ZVS ZVT - OBP .
ZVU ZVV - OGC .
ZVW ZVX - OGD .
ZWA ZWB - OCH .
ZWC ZWD - OCP .
ZWE ZWF - IFP .
ZWG ZWH - IEH .
ZWI ZWJ - IEP .
ZWK ZWL - IFH .
ZWM ZWN - IDH .
ZWO ZWP - IDP .
ZWQ ZWR - IAH .
ZWS ZWT - IAP .
ZWU ZWV - IGH .
ZWW ZWX - IBH .
ZXA ZXB - IBP .
ZXC ZXD - ICQ .
ZXE ZXF - ICT .
ZXG ZXH - ICS .
ZXI ZXJ - IDS .
ZXK ZXL - IDQ .
ZXM ZXN - ICH .
ZXO ZXP - ICP .
ZXQ ZXR - *** .
ZXS ZXT - *** .
ZXU ZXV - *** .
ZXW ZXX - *** .
