*
* Connector Definitions
* Module: TA/TF
* Description: Memory interface modules, packetize address and data, SECDED
* Revision:
* Date: 
*    
ZAA ZAB - OAA .
ZAC ZAD - OAB .
ZAE ZAF - OAC .
ZAG ZAH - OAD .
ZAI ZAJ - OAE .
ZAK ZAL - OAF .
ZAM ZAN - OAG .
ZAO ZAP - OAH .
ZAQ ZAR - OAI .
ZAS ZAT - OAJ .
ZAU ZAV - OAK .
ZAW ZAX - OAL .
ZBA ZBB - OAM .
ZBC ZBD - OAN .
ZBE ZBF - OBA .
ZBG ZBH - OBB .
ZBI ZBJ - OBC .
ZBK ZBL - OBD .
ZBM ZBN - OBE .
ZBO ZBP - OBF .
ZBQ ZBR - OBG .
ZBS ZBT - OBH .
ZBU ZBV - OBI .
ZBW ZBX - OBJ .
ZCA ZCB - OBK .
ZCC ZCD - OBL .
ZCE ZCF - OBM .
ZCG ZCH - OBN .
ZCI ZCJ - OCA .
ZCK ZCL - OCB .
ZCM ZCN - OCC .
ZCO ZCP - OCD .
ZCQ ZCR - OCE .
ZCS ZCT - OCF .
ZCU ZCV - OCG .
ZCW ZCX - OCH .
       	       
ZDA ZDB - OCI .
ZDC ZDD - OCJ .
ZDE ZDF - OCK .
ZDG ZDH - OCL .
ZDI ZDJ - OCM .
ZDK ZDL - OCN .
ZDM ZDN - ODA .
ZDO ZDP - ODB .
ZDQ ZDR - ODC .
ZDS ZDT - ODD .
ZDU ZDV - ODE .
ZDW ZDX - ODF .
ZEA ZEB - ODG .
ZEC ZED - ODH .
ZEE ZEF - ODI .
ZEG ZEH - ODJ .
ZEI ZEJ - ODK .
ZEK ZEL - ODL .
ZEM ZEN - ODM .
ZEO ZEP - ODN .
ZEQ ZER - OEA .
ZES ZET - OEB .
ZEU ZEV - OEC .
ZEW ZEX - OED .
ZFA ZFB - OEE .
ZFC ZFD - OEF .
ZFE ZFF - OEG .
ZFG ZFH - OEH .
ZFI ZFJ - OEI .
ZFK ZFL - OEJ .
ZFM ZFN - OEK .
ZFO ZFP - OEL .
ZFQ ZFR - OEM .
ZFS ZFT - OEN .
ZFU ZFV - OEO .
ZFW ZFX - OEP .
  
ZGA ZGB - OEQ .
ZGC ZGD - OER .
ZGE ZGF - OES .
ZGG ZGH - OET .
ZGI ZGJ - OEU .
ZGK ZGL - OEV .
ZGM ZGN - OEW .
ZGO ZGP - OEX .
ZGQ ZGR - OFA .
ZGS ZGT - OFB .
ZGU ZGV - OFC .
ZGW ZGX - OFD .
ZHA ZHB - OHA .
ZHC ZHD - OHB .
ZHE ZHF - OHC .
ZHG ZHH - OHD .
ZHI ZHJ - OHE .
ZHK ZHL - OIA .
ZHM ZHN - OIB .
ZHO ZHP - OIC .
ZHQ ZHR - OID .
ZHS ZHT - OIE .
ZHU ZHV - OIF .
ZHW ZHX - OIG .
ZIA ZIB - OIH .
ZIC ZID - OKA .
ZIE ZIF - OLA .
ZIG ZIH - OLB .
ZII ZIJ - OLC .
ZIK ZIL - OLD . 
ZIM ZIN - IAA .
ZIO ZIP - IAB .
ZIQ ZIR - IAC .
ZIS ZIT - IAD .
ZIU ZIV - IAE .
ZIW ZIX - IAF .
             
ZJA ZJB - IAG .
ZJC ZJD - IAH .
ZJE ZJF - IAI .
ZJG ZJH - IAJ .
ZJI ZJJ - IAK .
ZJK ZJL - IAL .
ZJM ZJN - IAM .
ZJO ZJP - IAN .
ZJQ ZJR - IAO .
ZJS ZJT - IAP .
ZJU ZJV - IBA .
ZJW ZJX - IBB .
ZKA ZKB - IBC .
ZKC ZKD - IBD .
ZKE ZKF - IBE .
ZKG ZKH - IBF .
ZKI ZKJ - IBG .
ZKK ZKL - IBH .
ZKM ZKN - IBI .
ZKO ZKP - IBJ .
ZKQ ZKR - IBK .
ZKS ZKT - IBL .
ZKU ZKV - IBM .
ZKW ZKX - IBN .
ZLA ZLB - IBO .
ZLC ZLD - IBP .
ZLE ZLF - ICA .
ZLG ZLH - ICB .
ZLI ZLJ - ICC .
ZLK ZLL - ICD .
ZLM ZLN - ICE .
ZLO ZLP - ICF .
ZLQ ZLR - ICG .
ZLS ZLT - ICH .
ZLU ZLV - ICI .
ZLW ZLX - ICJ .
           
ZMA ZMB - ICK .
ZMC ZMD - ICL .
ZME ZMF - ICM .
ZMG ZMH - ICN .
ZMI ZMJ - ICO .
ZMK ZML - ICP .
ZMM ZMN - IDA .
ZMO ZMP - IDB .
ZMQ ZMR - IDC .
ZMS ZMT - IDD .
ZMU ZMV - IDE .
ZMW ZMX - IDF .
ZNA ZNB - IDG .
ZNC ZND - IDH .
ZNE ZNF - IDI .
ZNG ZNH - IDJ .
ZNI ZNJ - IDK .
ZNK ZNL - IDL .
ZNM ZNN - IDM .
ZNO ZNP - IDN .
ZNQ ZNR - IDO .
ZNS ZNT - IDP .
ZNU ZNV - IEA .
ZNW ZNX - IEB .
ZOA ZOB - IEC .
ZOC ZOD - IED .
ZOE ZOF - IEE .
ZOG ZOH - IEF .
ZOI ZOJ - IEG .
ZOK ZOL - IEH .
ZOM ZON - IEI .
ZOO ZOP - IEJ .
ZOQ ZOR - IEK .
ZOS ZOT - IEL .
ZOU ZOV - IEN .
ZOW ZOX - IEM .
           
ZPA ZPB - IEO .
ZPC ZPD - IEP .
ZPE ZPF - IFA .
ZPG ZPH - IFB .
ZPI ZPJ - IFC .
ZPK ZPL - IFD .
ZPM ZPN - IFE .
ZPO ZPP - IFF .
ZPQ ZPR - IFG .
ZPS ZPT - IFH .
ZPU ZPV - IFI .
ZPW ZPX - IFJ .
ZQA ZQB - IFK .
ZQC ZQD - IFL .
ZQE ZQF - IFM .
ZQG ZQH - IFN .
ZQI ZQJ - IFO .
ZQK ZQL - IFP .
ZQM ZQN - IGA .
ZQO ZQP - IGB .
ZQQ ZQR - IGC .
ZQS ZQT - IGD .
ZQU ZQV - IGE .
ZQW ZQX - IGF .
ZRA ZRB - IGG .
ZRC ZRD - IGH .
ZRE ZRF - IGI .
ZRG ZRH - IGJ .
ZRI ZRJ - IGK .
ZRK ZRL - IGL .
ZRM ZRN - IGM .
ZRO ZRP - IGN .
ZRQ ZRR - IHB .
ZRS ZRT - IGO .
ZRU ZRV - IGP .
ZRW ZRX - IHA .
         
ZSA ZSB - IHC .
ZSC ZSD - IHD .
ZSE ZSF - IHE .
ZSG ZSH - IHF .
ZSI ZSJ - IHG .
ZSK ZSL - IHH .
ZSM ZSN - IHI .
ZSO ZSP - IHJ .
ZSQ ZSR - IHK .
ZSS ZST - IHL .
ZSU ZSV - IHM .
ZSW ZSX - IHN .
ZTA ZTB - IHO .
ZTC ZTD - IHP .
ZTE ZTF - IIA .
ZTG ZTH - IIB .
ZTI ZTJ - IIC .
ZTK ZTL - IID .
ZTM ZTN - IIE .
ZTO ZTP - IIF .
ZTQ ZTR - IJA .
ZTS ZTT - IJB .
ZTU ZTV - IJC .
ZTW ZTX - IJD .
ZUA ZUB - IJE .
ZUC ZUD - IJF .
ZUE ZUF - IJG .
ZUG ZUH - IJH .
ZUI ZUJ - IKA .
ZUK ZUL - IKB .
ZUM ZUN - IKC .
ZUO ZUP - IKD .
ZUQ ZUR - IKE .
ZUS ZUT - IKF .
ZUU ZUV - IKG .
ZUW ZUX - IKH .
         
ZVA ZVB - IKJ .
ZVC ZVD - IKK .
ZVE ZVF - IKM .
ZVG ZVH - IKN .
ZVI ZVJ - IKO .
ZVK ZVL - IKP .
ZVM ZVN - IKQ .
ZVO ZVP - IKR .
ZVQ ZVR - IKS .
ZVS ZVT - IKT .
ZVU ZVV - IKU .
ZVW ZVX - ILA .
ZWA ZWB - IKI .
ZWC ZWD - *** .  
ZWE ZWF - *** .  
ZWG ZWH - *** .  
ZWI ZWJ - *** .  
ZWK ZWL - *** .  
ZWM ZWN - *** .  
ZWO ZWP - *** . 
ZWQ ZWR - *** . 
ZWS ZWT - *** . 
ZWU ZWV - *** . 
ZWW ZWX - *** . 
ZXA ZXB - *** . 
ZXC ZXD - *** . 
ZXE ZXF - *** . 
ZXG ZXH - *** . 
ZXI ZXJ - *** . 
ZXK ZXL - *** . 
ZXM ZXN - *** . 
ZXO ZXP - *** . 
ZXQ ZXR - *** . 
ZXS ZXT - *** . 
ZXU ZXV - *** . 
ZXW ZXX - *** . 
 
