*
* Connector Definitions
* Module: QB
* Description: Memory Access Control
* Revision: 
* Date: 
*   
ZAA ZAB - IAA .
ZAC ZAD - IAB .
ZAE ZAF - IAC .
ZAG ZAH - IAD .
ZAI ZAJ - IAE .
ZAK ZAL - IAF .
ZAM ZAN - IAG .
ZAO ZAP - IAH .
ZAQ ZAR - IAI .
ZAS ZAT - IAJ .
ZAU ZAV - IAK .
ZAW ZAX - IAL .
ZBA ZBB - IBA .
ZBC ZBD - IBB .
ZBE ZBF - IBC .
ZBG ZBH - IBD .
ZBI ZBJ - IBE .
ZBK ZBL - IBF .
ZBM ZBN - IBG .
ZBO ZBP - IBH .
ZBQ ZBR - IBI .
ZBS ZBT - IBJ .
ZBU ZBV - IBK .
ZBW ZBX - IBL .
ZCA ZCB - ICA .
ZCC ZCD - ICB .
ZCE ZCF - ICC .
ZCG ZCH - ICD .
ZCI ZCJ - ICE .
ZCK ZCL - ICF .
ZCM ZCN - ICG .
ZCO ZCP - ICH .
ZCQ ZCR - ICI .
ZCS ZCT - ICJ .
ZCU ZCV - ICK .
ZCW ZCX - ICL .
       	        
ZDA ZDB - IDA .
ZDC ZDD - IDB .
ZDE ZDF - IDC .
ZDG ZDH - IDD .
ZDI ZDJ - IDE .
ZDK ZDL - IDF .
ZDM ZDN - IDG .
ZDO ZDP - IDH .
ZDQ ZDR - IDI .
ZDS ZDT - IDJ .
ZDU ZDV - IDK .
ZDW ZDX - IDL .
ZEA ZEB - IEA .
ZEC ZED - IEB .
ZEE ZEF - IEC .
ZEG ZEH - IED .
ZEI ZEJ - IEE .
ZEK ZEL - IEF .
ZEM ZEN - IEG .
ZEO ZEP - IEH .
ZEQ ZER - IEI .
ZES ZET - IEJ .
ZEU ZEV - IEK .
ZEW ZEX - IEL .
ZFA ZFB - IEM .
ZFC ZFD - IEN .
ZFE ZFF - IEO .
ZFG ZFH - IEP .
ZFI ZFJ - IEQ .
ZFK ZFL - IER .
ZFM ZFN - IES .
ZFO ZFP - IET .
ZFQ ZFR - IEU .
ZFS ZFT - IEV .
ZFU ZFV - IEW .
ZFW ZFX - IEX .
   
ZGA ZGB - IFA .
ZGC ZGD - IFB .
ZGE ZGF - IFC .
ZGG ZGH - IFD .
ZGI ZGJ - IFE .
ZGK ZGL - IGA .
ZGM ZGN - IGB .
ZGO ZGP - IGC .
ZGQ ZGR - IJA .
ZGS ZGT - IJB .
ZGU ZGV - IJC .
ZGW ZGX - IJD .
ZHA ZHB - IJE .
ZHC ZHD - IJF .
ZHE ZHF - IJG .
ZHG ZHH - IJH .
ZHI ZHJ - IJI .
ZHK ZHL - IJJ .
ZHM ZHN - IJK .
ZHO ZHP - IJL .
ZHQ ZHR - IJM .
ZHS ZHT - IJN .
ZHU ZHV - IJO .
ZHW ZHX - IJP .
ZIA ZIB - IKA .
ZIC ZID - IKB .
ZIE ZIF - IKC .
ZIG ZIH - IKD .
ZII ZIJ - IKE .
ZIK ZIL - IKF .
ZIM ZIN - IKG .
ZIO ZIP - IKH .
ZIQ ZIR - IKI .
ZIS ZIT - IKJ .
ZIU ZIV - IKK .
ZIW ZIX - IKL .

ZJA ZJB - IKM .
ZJC ZJD - IKN .
ZJE ZJF - IKO .
ZJG ZJH - IKP .
ZJI ZJJ - OAA .
ZJK ZJL - OAB .
ZJM ZJN - OAC .
ZJO ZJP - OAD .
ZJQ ZJR - OAE .
ZJS ZJT - OAF .
ZJU ZJV - OAG .
ZJW ZJX - OAH .
ZKA ZKB - OAI .
ZKC ZKD - OAJ .
ZKE ZKF - OAK .
ZKG ZKH - OAL .
ZKI ZKJ - OAM .
ZKK ZKL - OAN .
ZKM ZKN - OAO .
ZKO ZKP - OAP .
ZKQ ZKR - OBA .
ZKS ZKT - OBB .
ZKU ZKV - OBC .
ZKW ZKX - OBD .
ZLA ZLB - OBE .
ZLC ZLD - OBF .
ZLE ZLF - OBG .
ZLG ZLH - OBH .
ZLI ZLJ - OBI .
ZLK ZLL - OBJ .
ZLM ZLN - OBK .
ZLO ZLP - OBL .
ZLQ ZLR - OBM .
ZLS ZLT - OBN .
ZLU ZLV - OBP .
ZLW ZLX - OBO .

ZMA ZMB - ODA .
ZMC ZMD - ODB .
ZME ZMF - ODC .
ZMG ZMH - ODD .
ZMI ZMJ - ODE .
ZMK ZML - ODF .
ZMM ZMN - ODG .
ZMO ZMP - ODH .
ZMQ ZMR - OEA .
ZMS ZMT - OEB .
ZMU ZMV - OEC .
ZMW ZMX - OED .
ZNA ZNB - OEE .
ZNC ZND - OEF .
ZNE ZNF - OEG .
ZNG ZNH - OEH .
ZNI ZNJ - OFA .
ZNK ZNL - OFB .
ZNM ZNN - OFC .
ZNO ZNP - OFD .
ZNQ ZNR - OFE .
ZNS ZNT - OGA .
ZNU ZNV - OGB .
ZNW ZNX - OGC .
ZOA ZOB - OGD .
ZOC ZOD - OGE .
ZOE ZOF - OHA .
ZOG ZOH - OHB .
ZOI ZOJ - OHC .
ZOK ZOL - OHD .
ZOM ZON - OHE .
ZOO ZOP - OIA .
ZOQ ZOR - OIB .
ZOS ZOT - OIC .
ZOU ZOV - OIE .
ZOW ZOX - OID .

ZPA ZPB - OJA .
ZPC ZPD - OJB .
ZPE ZPF - OJC .
ZPG ZPH - OJD .
ZPI ZPJ - OJE .
ZPK ZPL - OJF .
ZPM ZPN - OKA .
ZPO ZPP - OKB .
ZPQ ZPR - OKC .
ZPS ZPT - OKD .
ZPU ZPV - OKE .
ZPW ZPX - OKF .
ZQA ZQB - OLA .
ZQC ZQD - OLB .
ZQE ZQF - OLC .
ZQG ZQH - OLD .
ZQI ZQJ - OLE .
ZQK ZQL - OLF .
ZQM ZQN - OMA .
ZQO ZQP - OMB .
ZQQ ZQR - OMC .
ZQS ZQT - OMD .
ZQU ZQV - OME .
ZQW ZQX - OMF .
ZRA ZRB - ONA .
ZRC ZRD - ONB .
ZRE ZRF - ONC .
ZRG ZRH - OND .
ZRI ZRJ - ONE .
ZRK ZRL - ONF .
ZRM ZRN - ONG .
ZRO ZRP - ONH .
ZRQ ZRR - ONI .
ZRS ZRT - ONJ .
ZRU ZRV - ONK .
ZRW ZRX - ONL .

ZSA ZSB - ONN .
ZSC ZSD - ONM .
ZSE ZSF - ONO .
ZSG ZSH - ONP .
ZSI ZSJ - OOA .
ZSK ZSL - OOB .
ZSM ZSN - OOC .
ZSO ZSP - OOD .
ZSQ ZSR - OOE .
ZSS ZST - OOF .
ZSU ZSV - OOG .
ZSW ZSX - OOH .
ZTA ZTB - OOI .
ZTC ZTD - OOJ .
ZTE ZTF - OOK .
ZTG ZTH - OOL .
ZTI ZTJ - OOM .
ZTK ZTL - OON .
ZTM ZTN - OOO .
ZTO ZTP - OOP .
ZTQ ZTR - OPA .
ZTS ZTT - OPB .
ZTU ZTV - OPC .
ZTW ZTX - OPD .
ZUA ZUB - OPE .
ZUC ZUD - OPF .
ZUE ZUF - OPG .
ZUG ZUH - OPH .
ZUI ZUJ - OPI .
ZUK ZUL - OPJ .
ZUM ZUN - OPK .
ZUO ZUP - OPL .
ZUQ ZUR - OPM .
ZUS ZUT - OPN .
ZUU ZUV - OPO .
ZUW ZUX - OPP .
          
ZVA ZVB - OQB .
ZVC ZVD - OQC .
ZVE ZVF - OQD .
ZVG ZVH - OQE .
ZVI ZVJ - OQF .
ZVK ZVL - OQG .
ZVM ZVN - OQH .
ZVO ZVP - OQI .
ZVQ ZVR - OQJ .
ZVS ZVT - OQK .
ZVU ZVV - OQL .
ZVW ZVX - OQM .
ZWA ZWB - OQN .
ZWC ZWD - OQO .
ZWE ZWF - OQA .
ZWG ZWH - *** . 
ZWI ZWJ - *** . 
ZWK ZWL - *** . 
ZWM ZWN - *** . 
ZWO ZWP - *** . 
ZWQ ZWR - *** . 
ZWS ZWT - *** . 
ZWU ZWV - *** . 
ZWW ZWX - *** . 
ZXA ZXB - *** . 
ZXC ZXD - *** . 
ZXE ZXF - *** . 
ZXG ZXH - *** . 
ZXI ZXJ - *** . 
ZXK ZXL - *** . 
ZXM ZXN - *** . 
ZXO ZXP - *** . 
ZXQ ZXR - *** . 
ZXS ZXT - *** . 
ZXU ZXV - *** . 
ZXW ZXX - *** .
       
