*
* Connector Definitions
* Module: MB
* Description: Floating multiply, reciprocal, reciprocal square root
* Revision: 
* Date: 
* 
ZAA ZAB - IGC .
ZAC ZAD - IGD .
ZAE ZAF - IGE .
ZAG ZAH - IGF .
ZAI ZAJ - IGG .
ZAK ZAL - IGH .
ZAM ZAN - IGI .
ZAO ZAP - IGJ .
ZAQ ZAR - IGK .
ZAS ZAT - IGL .
ZAU ZAV - IGM .
ZAW ZAX - IGN .
ZBA ZBB - IGO .
ZBC ZBD - IGP .
ZBE ZBF - IBA .
ZBG ZBH - IBB .
ZBI ZBJ - IBC .
ZBK ZBL - IBD .
ZBM ZBN - IBE .
ZBO ZBP - IBF .
ZBQ ZBR - IBG .
ZBS ZBT - IBH .
ZBU ZBV - IBI .
ZBW ZBX - IBJ .
ZCA ZCB - IGA .
ZCC ZCD - IGB .
ZCE ZCF - IRA .
ZCG ZCH - IDA .
ZCI ZCJ - ITB .
ZCK ZCL - IDB .
ZCM ZCN - IEQ .
ZCO ZCP - IER .
ZCQ ZCR - IES .
ZCS ZCT - IET .
ZCU ZCV - IEU .
ZCW ZCX - IEV .
       
ZDA ZDB - IBK .
ZDC ZDD - IBL .
ZDE ZDF - IBM .
ZDG ZDH - IBN .
ZDI ZDJ - IBO .
ZDK ZDL - IBP .
ZDM ZDN - ICA .
ZDO ZDP - ICB .
ZDQ ZDR - ICC .
ZDS ZDT - ICD .
ZDU ZDV - ICE .
ZDW ZDX - ICF .
ZEA ZEB - ICG .
ZEC ZED - ICH .
ZEE ZEF - ICI .
ZEG ZEH - ICJ .
ZEI ZEJ - ICK .
ZEK ZEL - ICL .
ZEM ZEN - ICM .
ZEO ZEP - ICN .
ZEQ ZER - ICO .
ZES ZET - ICP .
ZEU ZEV - ILO .
ZEW ZEX - ILP .
ZFA ZFB - *** .
ZFC ZFD - *** .
ZFE ZFF - *** .
ZFG ZFH - *** .
ZFI ZFJ - *** .
ZFK ZFL - *** .
ZFM ZFN - *** .
ZFO ZFP - *** .
ZFQ ZFR - ISA .
ZFS ZFT - ITA .
ZFU ZFV - IIA .
ZFW ZFX - IHA .
       
ZGA ZGB - *** . 
ZGC ZGD - IMK .
ZGE ZGF - ING .
ZGG ZGH - INE .
ZGI ZGJ - INF .
ZGK ZGL - IOA .
ZGM ZGN - IOB .
ZGO ZGP - IOC .
ZGQ ZGR - OGA .
ZGS ZGT - OGB .
ZGU ZGV - OGC .
ZGW ZGX - OGD .
ZHA ZHB - OGE .
ZHC ZHD - OGF .
ZHE ZHF - OGG .
ZHG ZHH - OGH .
ZHI ZHJ - OGI .
ZHK ZHL - OGJ .
ZHM ZHN - OGK .
ZHO ZHP - OGL .
ZHQ ZHR - OGM .
ZHS ZHT - OHA .
ZHU ZHV - OHB .
ZHW ZHX - OHC .
ZIA ZIB - IKA .
ZIC ZID - *** .
ZIE ZIF - *** .
ZIG ZIH - *** .
ZII ZIJ - ODL .
ZIK ZIL - ODM .
ZIM ZIN - ODN .
ZIO ZIP - ODO .
ZIQ ZIR - ODP .
ZIS ZIT - IEW .
ZIU ZIV - IEX .
ZIW ZIX - IEY .
       
ZJA ZJB - OHD .
ZJC ZJD - OHE .
ZJE ZJF - OHF .
ZJG ZJH - OHG .
ZJI ZJJ - OHH .
ZJK ZJL - OHI .
ZJM ZJN - OHJ .
ZJO ZJP - *** .
ZJQ ZJR - *** .
ZJS ZJT - OKA .
ZJU ZJV - OKB .
ZJW ZJX - OKC .
ZKA ZKB - OKD .
ZKC ZKD - OKE .
ZKE ZKF - OLD .
ZKG ZKH - OMA .
ZKI ZKJ - OMB .
ZKK ZKL - OPA .
ZKM ZKN - OPB .
ZKO ZKP - OPC .
ZKQ ZKR - OPD .
ZKS ZKT - OPE .
ZKU ZKV - OPF .
ZKW ZKX - OPG .
ZLA ZLB - OPH .
ZLC ZLD - OPI .
ZLE ZLF - OPK .
ZLG ZLH - OPM .
ZLI ZLJ - OPO .
ZLK ZLL - OPQ .
ZLM ZLN - OPR .
ZLO ZLP - OQA .
ZLQ ZLR - OQC .
ZLS ZLT - OQE .
ZLU ZLV - OQI .
ZLW ZLX - OQK . 
       	     
ZMA ZMB - OQO . 
ZMC ZMD - OQQ .
ZME ZMF - *** .
ZMG ZMH - OQM .
ZMI ZMJ - IEZ .
ZMK ZML - IDC .
ZMM ZMN - IDD .
ZMO ZMP - IDE .
ZMQ ZMR - IDF .
ZMS ZMT - IDG .
ZMU ZMV - IDH .
ZMW ZMX - IDI .
ZNA ZNB - IDJ .
ZNC ZND - IDK .
ZNE ZNF - IDL .
ZNG ZNH - IDM .
ZNI ZNJ - IDO .
ZNK ZNL - IDP .
ZNM ZNN - *** .
ZNO ZNP - *** .
ZNQ ZNR - *** .
ZNS ZNT - *** .
ZNU ZNV - *** .
ZNW ZNX - *** .
ZOA ZOB - *** .
ZOC ZOD - *** .
ZOE ZOF - *** .
ZOG ZOH - *** .
ZOI ZOJ - *** .
ZOK ZOL - OBL .
ZOM ZON - OBM .
ZOO ZOP - OBN .
ZOQ ZOR - OBO .
ZOS ZOT - OBP .
ZOU ZOV - IDN .
ZOW ZOX - *** .
       
ZPA ZPB - IEA .
ZPC ZPD - IEB .
ZPE ZPF - IEC .
ZPG ZPH - IED .
ZPI ZPJ - IEE .
ZPK ZPL - IEF .
ZPM ZPN - IEG .
ZPO ZPP - IEH .
ZPQ ZPR - IEI .
ZPS ZPT - IEJ .
ZPU ZPV - IEK .
ZPW ZPX - IEL .
ZQA ZQB - IEM .
ZQC ZQD - IEN .
ZQE ZQF - IEO .
ZQG ZQH - IEP .
ZQI ZQJ - OCA .
ZQK ZQL - OCB .
ZQM ZQN - OCC .
ZQO ZQP - OCD .
ZQQ ZQR - OCE .
ZQS ZQT - OCF .
ZQU ZQV - OCG .
ZQW ZQX - OCH .
ZRA ZRB - OCI .
ZRC ZRD - OCJ .
ZRE ZRF - OCK .
ZRG ZRH - OCL .
ZRI ZRJ - OCM .
ZRK ZRL - OCN .
ZRM ZRN - OCO .
ZRO ZRP - OCP .
ZRQ ZRR - INA .
ZRS ZRT - INB .
ZRU ZRV - INC .
ZRW ZRX - IND .
     
ZSA ZSB - IFA .
ZSC ZSD - IFB .
ZSE ZSF - IFC .
ZSG ZSH - IFD .
ZSI ZSJ - IFE .
ZSK ZSL - IFF .
ZSM ZSN - IFG .
ZSO ZSP - IFH .
ZSQ ZSR - IFI .
ZSS ZST - IFJ .
ZSU ZSV - IFK .
ZSW ZSX - IFL .
ZTA ZTB - IFM .
ZTC ZTD - IFN .
ZTE ZTF - IFO .
ZTG ZTH - IFP .
ZTI ZTJ - *** .
ZTK ZTL - *** .
ZTM ZTN - IMA .
ZTO ZTP - IMB .
ZTQ ZTR - IMC .
ZTS ZTT - IMD .
ZTU ZTV - IME .
ZTW ZTX - IMF .
ZUA ZUB - IMG .
ZUC ZUD - IMH .
ZUE ZUF - IMI .
ZUG ZUH - IMJ .
ZUI ZUJ - *** .
ZUK ZUL - IML .
ZUM ZUN - IMM .
ZUO ZUP - IMN .
ZUQ ZUR - *** .
ZUS ZUT - *** .
ZUU ZUV - *** .
ZUW ZUX - *** .
     
ZVA ZVB - OAA .
ZVC ZVD - OAB .
ZVE ZVF - OAC .
ZVG ZVH - OAD .
ZVI ZVJ - OAE .
ZVK ZVL - OAF .
ZVM ZVN - OAG .
ZVO ZVP - OAH .
ZVQ ZVR - OAI .
ZVS ZVT - OAJ .
ZVU ZVV - OAK .
ZVW ZVX - OAL .
ZWA ZWB - OAM .
ZWC ZWD - OAN .
ZWE ZWF - OAO .
ZWG ZWH - OAP .
ZWI ZWJ - *** .
ZWK ZWL - ILA .
ZWM ZWN - ILB .
ZWO ZWP - ILC .
ZWQ ZWR - ILD .
ZWS ZWT - ILE .
ZWU ZWV - ILF .
ZWW ZWX - ILG .
ZXA ZXB - ILH .
ZXC ZXD - ILI .
ZXE ZXF - ILJ .
ZXG ZXH - ILK .
ZXI ZXJ - ILL .
ZXK ZXL - ILM .
ZXM ZXN - ILN .
ZXO ZXP - *** .
ZXQ ZXR - *** .
ZXS ZXT - *** .
ZXU ZXV - *** .
ZXW ZXX - *** .         
