*
* Connector Definitions
* Module: FA
* Description: Floating Point Addition
* Revision:
* Date:
*
ZAA ZAB - IAA .
ZAC ZAD - IAB .
ZAE ZAF - IAC .
ZAG ZAH - IAD .
ZAI ZAJ - IAE .
ZAK ZAL - IAF .
ZAM ZAN - IAG .
ZAO ZAP - IAH .
ZAQ ZAR - IAI .
ZAS ZAT - IAJ .
ZAU ZAV - IAK .
ZAW ZAX - IAL .
ZBA ZBB - IAM .
ZBC ZBD - IAN .
ZBE ZBF - IAO .
ZBG ZBH - IAP .
ZBI ZBJ - IBA .
ZBK ZBL - IBB .
ZBM ZBN - IBC .
ZBO ZBP - IBD .
ZBQ ZBR - IBE .
ZBS ZBT - IBF .
ZBU ZBV - IBG .
ZBW ZBX - IBH .
ZCA ZCB - IBI .
ZCC ZCD - IBJ .
ZCE ZCF - IBK .
ZCG ZCH - IBL .
ZCI ZCJ - IBM .
ZCK ZCL - IBN .
ZCM ZCN - IBO .
ZCO ZCP - IBP .
ZCQ ZCR - ICA .
ZCS ZCT - ICB .
ZCU ZCV - ICC .
ZCW ZCX - ICD .
       	    
ZDA ZDB - ICE .
ZDC ZDD - ICF .
ZDE ZDF - ICG .
ZDG ZDH - ICH .
ZDI ZDJ - ICI .
ZDK ZDL - ICJ .
ZDM ZDN - ICK .
ZDO ZDP - ICL .
ZDQ ZDR - ICM .
ZDS ZDT - ICN .
ZDU ZDV - ICO .
ZDW ZDX - ICP .
ZEA ZEB - IDA .
ZEC ZED - IDB .
ZEE ZEF - IDC .
ZEG ZEH - IDD .
ZEI ZEJ - IDE .
ZEK ZEL - IDF .
ZEM ZEN - IDG .
ZEO ZEP - IDH .
ZEQ ZER - IDI .
ZES ZET - IDJ .
ZEU ZEV - IDK .
ZEW ZEX - IDL .
ZFA ZFB - IDM .
ZFC ZFD - IDN .
ZFE ZFF - IDO .
ZFG ZFH - IDP .
ZFI ZFJ - IEA .
ZFK ZFL - IEB .
ZFM ZFN - IEC .
ZFO ZFP - IED .
ZFQ ZFR - IEE .
ZFS ZFT - IEF .
ZFU ZFV - IEG .
ZFW ZFX - IEH .
         
ZGA ZGB - IEI .
ZGC ZGD - IEJ .
ZGE ZGF - IEK .
ZGG ZGH - IEL .
ZGI ZGJ - IEM .
ZGK ZGL - IEN .
ZGM ZGN - IEO .
ZGO ZGP - IEP .
ZGQ ZGR - IFA .
ZGS ZGT - IFB .
ZGU ZGV - IFC .
ZGW ZGX - IFD .
ZHA ZHB - IFE .
ZHC ZHD - IFF .
ZHE ZHF - IFG .
ZHG ZHH - IFH .
ZHI ZHJ - IFI .
ZHK ZHL - IFJ .
ZHM ZHN - IFK .
ZHO ZHP - IFL .
ZHQ ZHR - IFM .
ZHS ZHT - IFN .
ZHU ZHV - IFO .
ZHW ZHX - IFP .
ZIA ZIB - IGA .
ZIC ZID - IGB .
ZIE ZIF - IGC .
ZIG ZIH - IGD .
ZII ZIJ - IGE .
ZIK ZIL - IGF .
ZIM ZIN - IGG .
ZIO ZIP - IGH .
ZIQ ZIR - IGI .
ZIS ZIT - IGJ .
ZIU ZIV - IGK .
ZIW ZIX - IGL .
          
ZJA ZJB - IGM .
ZJC ZJD - IGN .
ZJE ZJF - IGO .
ZJG ZJH - IGP .
ZJI ZJJ - IHA .
ZJK ZJL - IHB .
ZJM ZJN - IHC .
ZJO ZJP - IHD .
ZJQ ZJR - IHE .
ZJS ZJT - IHF .
ZJU ZJV - IHG .
ZJW ZJX - IHH .
ZKA ZKB - IHI .
ZKC ZKD - IHJ .
ZKE ZKF - IHK .
ZKG ZKH - IHL .
ZKI ZKJ - IHM .
ZKK ZKL - IHN .
ZKM ZKN - IHO .
ZKO ZKP - IHP .
ZKQ ZKR - IJA .
ZKS ZKT - IJB .
ZKU ZKV - IJC .
ZKW ZKX - IJD .
ZLA ZLB - IJE .
ZLC ZLD - IKA .
ZLE ZLF - ILA .
ZLG ZLH - OAA .
ZLI ZLJ - OAB .
ZLK ZLL - OAC .
ZLM ZLN - OAD .
ZLO ZLP - OAE .
ZLQ ZLR - OAF .
ZLS ZLT - OAG .
ZLU ZLV - OAH .
ZLW ZLX - OAI .
        
ZMA ZMB - OAJ .
ZMC ZMD - OAK .
ZME ZMF - OAL .
ZMG ZMH - OAM .
ZMI ZMJ - OAN .
ZMK ZML - OAO .
ZMM ZMN - OAP .
ZMO ZMP - OAR .
ZMQ ZMR - OBA .
ZMS ZMT - OBB .
ZMU ZMV - OBC .
ZMW ZMX - OBD .
ZNA ZNB - OBE .
ZNC ZND - OBF .
ZNE ZNF - OBG .
ZNG ZNH - OBH .
ZNI ZNJ - OBI .
ZNK ZNL - OBJ .
ZNM ZNN - OBK .
ZNO ZNP - OBL .
ZNQ ZNR - OBM .
ZNS ZNT - OBN .
ZNU ZNV - OBO .
ZNW ZNX - OBP .
ZOA ZOB - OCA .
ZOC ZOD - OCB .
ZOE ZOF - OCC .
ZOG ZOH - OCD .
ZOI ZOJ - OCE .
ZOK ZOL - OCF .
ZOM ZON - OCG .
ZOO ZOP - OCH .
ZOQ ZOR - OCI .
ZOS ZOT - OCJ .
ZOU ZOV - OCL .
ZOW ZOX - OCK .
        
ZPA ZPB - OCM .
ZPC ZPD - OCN .
ZPE ZPF - OCO .
ZPG ZPH - OCP .
ZPI ZPJ - ODA .
ZPK ZPL - ODB .
ZPM ZPN - ODC .
ZPO ZPP - ODD .
ZPQ ZPR - ODE .
ZPS ZPT - ODF .
ZPU ZPV - ODG .
ZPW ZPX - ODH .
ZQA ZQB - ODI .
ZQC ZQD - ODJ .
ZQE ZQF - ODK .
ZQG ZQH - ODL .
ZQI ZQJ - ODM .
ZQK ZQL - ODN .
ZQM ZQN - ODO .
ZQO ZQP - ODP .
ZQQ ZQR - OEA .
ZQS ZQT - OEB .
ZQU ZQV - OEC .
ZQW ZQX - OEP .
ZRA ZRB - OED .
ZRC ZRD - OEE .
ZRE ZRF - OEF .
ZRG ZRH - OEG .
ZRI ZRJ - OEH .
ZRK ZRL - OEI .
ZRM ZRN - OEJ .
ZRO ZRP - OEK .
ZRQ ZRR - OEL .
ZRS ZRT - OEM .
ZRU ZRV - OEN .
ZRW ZRX - OEO .
      
ZSA ZSB - OFA .
ZSC ZSD - OFB .
ZSE ZSF - OFC .
ZSG ZSH - OFD .
ZSI ZSJ - OFE .
ZSK ZSL - OFF .
ZSM ZSN - OFG .
ZSO ZSP - OFH .
ZSQ ZSR - OFI .
ZSS ZST - OFJ .
ZSU ZSV - OFK .
ZSW ZSX - OFL .
ZTA ZTB - OFM .
ZTC ZTD - OFN .
ZTE ZTF - OFO .
ZTG ZTH - OFP .
ZTI ZTJ - OGA .
ZTK ZTL - OGB .
ZTM ZTN - OGC .
ZTO ZTP - OGD .
ZTQ ZTR - OGE .
ZTS ZTT - OGF .
ZTU ZTV - OGG .
ZTW ZTX - OGH .
ZUA ZUB - OGI .
ZUC ZUD - OGJ .
ZUE ZUF - OGK .
ZUG ZUH - OGL .
ZUI ZUJ - OGM .
ZUK ZUL - OGN .
ZUM ZUN - OGO .
ZUO ZUP - OGP .
ZUQ ZUR - OHA .
ZUS ZUT - OIA .
ZUU ZUV - OJA .
ZUW ZUX - OJB .
      
ZVA ZVB - OKA .                
ZVC ZVD - OJC .
ZVE ZVF - *** . 
ZVG ZVH - *** . 
ZVI ZVJ - *** . 
ZVK ZVL - *** . 
ZVM ZVN - *** . 
ZVO ZVP - *** . 
ZVQ ZVR - *** . 
ZVS ZVT - *** . 
ZVU ZVV - *** . 
ZVW ZVX - *** . 
ZWA ZWB - *** . 
ZWC ZWD - *** . 
ZWE ZWF - *** . 
ZWG ZWH - *** . 
ZWI ZWJ - *** . 
ZWK ZWL - *** . 
ZWM ZWN - *** . 
ZWO ZWP - *** . 
ZWQ ZWR - *** . 
ZWS ZWT - *** . 
ZWU ZWV - *** . 
ZWW ZWX - *** . 
ZXA ZXB - *** . 
ZXC ZXD - *** . 
ZXE ZXF - *** . 
ZXG ZXH - *** . 
ZXI ZXJ - *** . 
ZXK ZXL - *** . 
ZXM ZXN - *** . 
ZXO ZXP - *** . 
ZXQ ZXR - *** . 
ZXS ZXT - *** . 
ZXU ZXV - *** . 
ZXW ZXX - *** .         
