*
* Connection Definitions
* Module: EA
* Description: Foreground Processor Port
* Revision:
* Date:
*
ZAA ZAB - OAG .
ZAC ZAD - OAH .
ZAE ZAF - OAI .
ZAG ZAH - OAJ .
ZAI ZAJ - OAK .
ZAK ZAL - OAL .
ZAM ZAN - OMF .
ZAO ZAP - IAA .
ZAQ ZAR - IAI .
ZAS ZAT - ICA .
ZAU ZAV - OKA .
ZAW ZAX - IBA .
ZBA ZBB - IBI .
ZBC ZBD - OIA .
ZBE ZBF - OII .
ZBG ZBH - IDA .
ZBI ZBJ - OJK .
ZBK ZBL - OJL .
ZBM ZBN - *** .
ZBO ZBP - OHA .
ZBQ ZBR - OHI .
ZBS ZBT - ICI .
ZBU ZBV - OKI .
ZBW ZBX - ICQ .
ZCA ZCB - IEG .
ZCC ZCD - IGA .
ZCE ZCF - OKQ .
ZCG ZCH - OLC .
ZCI ZCJ - OMB .
ZCK ZCL - OMC .
ZCM ZCN - OMD .
ZCO ZCP - OAA .
ZCQ ZCR - OAB .
ZCS ZCT - OAC .
ZCU ZCV - OAD .
ZCW ZCX - OAE .
 
ZDA ZDB - OAF .
ZDC ZDD - OBG .
ZDE ZDF - OBH .
ZDG ZDH - OBI .
ZDI ZDJ - OBJ .
ZDK ZDL - OBK .
ZDM ZDN - OBL .
ZDO ZDP - IAB .
ZDQ ZDR - IAJ
ZDS ZDT - ICB .
ZDU ZDV - OKB .
ZDW ZDX - IBB .
ZEA ZEB - IBJ .
ZEC ZED - OIB .
ZEE ZEF - OIJ .
ZEG ZEH - ICJ .
ZEI ZEJ - IDB .
ZEK ZEL - IFD .
ZEM ZEN - *** .
ZEO ZEP - *** .
ZEQ ZER - OHB .
ZES ZET - OHJ .
ZEU ZEV - OKJ .
ZEW ZEX - ICR .
ZFA ZFB - OKR .
ZFC ZFD - IEE .
ZFE ZFF - IFA .
ZFG ZFH - IFB .
ZFI ZFJ - *** .
ZFK ZFL - OBA .
ZFM ZFN - OBB .
ZFO ZFP - OBC .
ZFQ ZFR - OBD .
ZFS ZFT - OBE .
ZFU ZFV - OCG .
ZFW ZFX - OBF .
  
ZGA ZGB - OCH .
ZGC ZGD - OCI .
ZGE ZGF - OCJ .
ZGG ZGH - OCK .
ZGI ZGJ - OCL .
ZGK ZGL - IAC .
ZGM ZGN - IAK .
ZGO ZGP - ICC .
ZGQ ZGR - OKC .
ZGS ZGT - IBC .
ZGU ZGV - IBK .
ZGW ZGX - OIC .
ZHA ZHB - OIK .
ZHC ZHD - ICK .
ZHE ZHF - IDC .
ZHG ZHH - IFC .
ZHI ZHJ - *** .
ZHK ZHL - *** .
ZHM ZHN - OHC .
ZHO ZHP - OHK .
ZHQ ZHR - OKK .
ZHS ZHT - IEF .
ZHU ZHV - ICS .
ZHW ZHX - OKS .
ZIA ZIB - IIA .
ZIC ZID - IIC .
ZIE ZIF - OME .
ZIG ZIH - OCA .
ZII ZIJ - OCB .
ZIK ZIL - OCC .
ZIM ZIN - OCD .
ZIO ZIP - OCE .
ZIQ ZIR - OCF .
ZIS ZIT - ODH .
ZIU ZIV - IXA .
ZIW ZIX - ODG .
  
ZJA ZJB - ODI .
ZJC ZJD - ODJ .
ZJE ZJF - ODK .
ZJG ZJH - ODL .
ZJI ZJJ - IAL .
ZJK ZJL - *** .
ZJM ZJN - ICD .
ZJO ZJP - OKD .
ZJQ ZJR - IAD .
ZJS ZJT - IBD .
ZJU ZJV - IBL .
ZJW ZJX - OID .
ZKA ZKB - OIL .
ZKC ZKD - ICL .
ZKE ZKF - IDD .
ZKG ZKH - *** .
ZKI ZKJ - *** .
ZKK ZKL - OHD .
ZKM ZKN - OHL .
ZKO ZKP - *** .
ZKQ ZKR - OKL .
ZKS ZKT - *** .
ZKU ZKV - ICT .
ZKW ZKX - OKT .
ZLA ZLB - OMA .
ZLC ZLD - IJA .
ZLE ZLF - IJB .
ZLG ZLH - IJC .
ZLI ZLJ - IJD .
ZLK ZLL - ODA .
ZLM ZLN - ODB .
ZLO ZLP - ODC .
ZLQ ZLR - ODD .
ZLS ZLT - ODE .
ZLU ZLV - OEG .
ZLW ZLX - ODF .
   
ZMA ZMB - OEH .
ZMC ZMD - OEI .
ZME ZMF - OEJ .
ZMG ZMH - OEK .
ZMI ZMJ - OEL .
ZMK ZML - IAE .
ZMM ZMN - ICE .
ZMO ZMP - OKE .
ZMQ ZMR - IBE .
ZMS ZMT - IBM .
ZMU ZMV - OIE .
ZMW ZMX - OIM .
ZNA ZNB - *** .
ZNC ZND - IDE .
ZNE ZNF - *** .
ZNG ZNH - IAM .
ZNI ZNJ - OHE .
ZNK ZNL - OHM .
ZNM ZNN - ICM .
ZNO ZNP - OKM .
ZNQ ZNR - IKA .
ZNS ZNT - IKB .
ZNU ZNV - IKC .
ZNW ZNX - IKD .
ZOA ZOB - OEA .
ZOC ZOD - OEB .
ZOE ZOF - OEC .
ZOG ZOH - OED .
ZOI ZOJ - OEE .
ZOK ZOL - OEF .
ZOM ZON - OFL .
ZOO ZOP - OFG .
ZOQ ZOR - OFH .
ZOS ZOT - OFI .
ZOU ZOV - OFJ .
ZOW ZOX - OFK .
   
ZPA ZPB - IAF .
ZPC ZPD - ICF .
ZPE ZPF - OKF .
ZPG ZPH - IAN .
ZPI ZPJ - IBF .
ZPK ZPL - IBN .
ZPM ZPN - OIF .
ZPO ZPP - OIN .
ZPQ ZPR - *** .
ZPS ZPT - *** .
ZPU ZPV - OHF .
ZPW ZPX - OHN .
ZQA ZQB - ICN .
ZQC ZQD - OKN .
ZQE ZQF - IKE .
ZQG ZQH - IKF .
ZQI ZQJ - IKG .
ZQK ZQL - IKH .
ZQM ZQN - IDF .
ZQO ZQP - ONA .
ZQQ ZQR - ONB .
ZQS ZQT - IHA .
ZQU ZQV - IHB .
ZQW ZQX - IHC .
ZRA ZRB - OFA .
ZRC ZRD - OFB .
ZRE ZRF - OFC .
ZRG ZRH - OFD .
ZRI ZRJ - OFE .
ZRK ZRL - OFF .
ZRM ZRN - OGL .
ZRO ZRP - OGG .
ZRQ ZRR - OGH .
ZRS ZRT - OGI .
ZRU ZRV - OGJ .
ZRW ZRX - OGK .
   
ZSA ZSB - IAG .
ZSC ZSD - ICG .
ZSE ZSF - OKG .
ZSG ZSH - IAO .
ZSI ZSJ - IBG .
ZSK ZSL - IBO .
ZSM ZSN - OIG .
ZSO ZSP - OIO .
ZSQ ZSR - IEA .
ZSS ZST - IEB .
ZSU ZSV - IED .
ZSW ZSX - *** .
ZTA ZTB - *** .
ZTC ZTD - OHG .
ZTE ZTF - OHO .
ZTG ZTH - ICO .
ZTI ZTJ - OKO .
ZTK ZTL - IKI .
ZTM ZTN - IKJ .
ZTO ZTP - IKK .
ZTQ ZTR - IKL .
ZTS ZTT - ILD .
ZTU ZTV - ILE .
ZTW ZTX - ILF .
ZUA ZUB - OLA .
ZUC ZUD - OOA .
ZUE ZUF - OGA .
ZUG ZUH - OGB .
ZUI ZUJ - OGC .
ZUK ZUL - OGD .
ZUM ZUN - OGE .
ZUO ZUP - OGF .
ZUQ ZUR - OJG .
ZUS ZUT - ILH .
ZUU ZUV - OJE .
ZUW ZUX - OJF .
   .
ZVA ZVB - OJH .
ZVC ZVD - OJI .
ZVE ZVF - OJJ .
ZVG ZVH - IAH .
ZVI ZVJ - IAP .
ZVK ZVL - ICH .
ZVM ZVN - OKH .
ZVO ZVP - IBH .
ZVQ ZVR - IBP .
ZVS ZVT - OIH .
ZVU ZVV - OIP .
ZVW ZVX - *** .
ZWA ZWB - *** .
ZWC ZWD - OHH .
ZWE ZWF - OHP .
ZWG ZWH - ICP .
ZWI ZWJ - OKP .
ZWK ZWL - IMA .
ZWM ZWN - IMB .
ZWO ZWP - IMC .
ZWQ ZWR - ILG .
ZWS ZWT - OLB .
ZWU ZWV - IMD .
ZWW ZWX - IME .
ZXA ZXB - IMF .
ZXC ZXD - IMG .
ZXE ZXF - IMH .
ZXG ZXH - ILA .
ZXI ZXJ - ILB .
ZXK ZXL - ILC .
ZXM ZXN - OJA .
ZXO ZXP - OJB .
ZXQ ZXR - OJC .
ZXS ZXT - OJD .
ZXU ZXV - IEC .
ZXW ZXX - IIB .    
