*
* Connector Definitions
* Module: WA
* Description: Local Memory
* Revision:
* Date: 
*
ZAA ZAB - IAA .
ZAC ZAD - IAB .
ZAE ZAF - IAC .
ZAG ZAH - IAD .
ZAI ZAJ - IAE .
ZAK ZAL - IAF .
ZAM ZAN - IAG .
ZAO ZAP - IAH .
ZAQ ZAR - IAI .
ZAS ZAT - IAJ .
ZAU ZAV - IAK .
ZAW ZAX - IAL .
ZBA ZBB - IAM .
ZBC ZBD - IAN .
ZBE ZBF - IAO .
ZBG ZBH - IAP .
ZBI ZBJ - IBA .
ZBK ZBL - IBB .
ZBM ZBN - IBC .
ZBO ZBP - IBD .
ZBQ ZBR - IBE .
ZBS ZBT - IBF .
ZBU ZBV - IBG .
ZBW ZBX - IBH .
ZCA ZCB - IBI .
ZCC ZCD - IBJ .
ZCE ZCF - IBK .
ZCG ZCH - IBL .
ZCI ZCJ - IBM .
ZCK ZCL - IBN .
ZCM ZCN - IBO .
ZCO ZCP - IBP .
ZCQ ZCR - ICA .
ZCS ZCT - ICB .
ZCU ZCV - ICC .
ZCW ZCX - ICD .

ZDA ZDB - ICE .
ZDC ZDD - ICF .
ZDE ZDF - ICG .
ZDG ZDH - ICH .
ZDI ZDJ - ICI .
ZDK ZDL - ICJ .
ZDM ZDN - ICK .
ZDO ZDP - ICL .
ZDQ ZDR - ICM .
ZDS ZDT - ICN .
ZDU ZDV - ICO .
ZDW ZDX - ICP .
ZEA ZEB - IDA .
ZEC ZED - IDB .
ZEE ZEF - IDC .
ZEG ZEH - IDD .
ZEI ZEJ - IDE .
ZEK ZEL - IDF .
ZEM ZEN - IDG .
ZEO ZEP - IDH .
ZEQ ZER - IDI .
ZES ZET - IDJ .
ZEU ZEV - IDK .
ZEW ZEX - IDL .
ZFA ZFB - IDM .
ZFC ZFD - IDN .
ZFE ZFF - IDO .
ZFG ZFH - IDP .
ZFI ZFJ - IEA .
ZFK ZFL - IEB .
ZFM ZFN - IEC .
ZFO ZFP - IED .
ZFQ ZFR - IEE .
ZFS ZFT - IEF .
ZFU ZFV - IEG .
ZFW ZFX - IEH .

ZGA ZGB - IEI .
ZGC ZGD - IEJ .
ZGE ZGF - IEK .
ZGG ZGH - IEL .
ZGI ZGJ - IEM .
ZGK ZGL - IEN .
ZGM ZGN - IGA .
ZGO ZGP - IGB .
ZGQ ZGR - IGC .
ZGS ZGT - IGD .
ZGU ZGV - IGE .
ZGW ZGX - IGF .
ZHA ZHB - IGG .
ZHC ZHD - IGH .
ZHE ZHF - IGI .
ZHG ZHH - IGJ .
ZHI ZHJ - IGK .
ZHK ZHL - IGL .
ZHM ZHN - IGM .
ZHO ZHP - IGN .
ZHQ ZHR - IHA .
ZHS ZHT - IHB .
ZHU ZHV - IIB .
ZHW ZHX - IJA .
ZIA ZIB - IJB .
ZIC ZID - IJC .
ZIE ZIF - IJD .
ZIG ZIH - BEA .
ZII ZIJ - OAA .
ZIK ZIL - OAB .
ZIM ZIN - OAC .
ZIO ZIP - OAD .
ZIQ ZIR - OAE .
ZIS ZIT - OAF .
ZIU ZIV - OAG .
ZIW ZIX - OAH .

ZJA ZJB - OAI .
ZJC ZJD - OAJ .
ZJE ZJF - OAK .
ZJG ZJH - OAL .
ZJI ZJJ - OAM .
ZJK ZJL - OAN .
ZJM ZJN - OAO .
ZJO ZJP - OAP .
ZJQ ZJR - OBA .
ZJS ZJT - OBB .
ZJU ZJV - OBC .
ZJW ZJX - OBD .
ZKA ZKB - OBE .
ZKC ZKD - OBF .
ZKE ZKF - OBG .
ZKG ZKH - OBH .
ZKI ZKJ - OBI .
ZKK ZKL - OBJ .
ZKM ZKN - OBK .
ZKO ZKP - OBL .
ZKQ ZKR - OBM .
ZKS ZKT - OBN .
ZKU ZKV - OBO .
ZKW ZKX - OBP .
ZLA ZLB - OCA .
ZLC ZLD - OCB .
ZLE ZLF - OCC .
ZLG ZLH - OCD .
ZLI ZLJ - OCE .
ZLK ZLL - OCF .
ZLM ZLN - OCG .
ZLO ZLP - OCH .
ZLQ ZLR - OCI .
ZLS ZLT - OCJ .
ZLU ZLV - OCK .
ZLW ZLX - OCL .

ZMA ZMB - OCM .
ZMC ZMD - OCN .
ZME ZMF - OCO .
ZMG ZMH - OCP .
ZMI ZMJ - ODA .
ZMK ZML - ODB .
ZMM ZMN - ODC .
ZMO ZMP - ODD .
ZMQ ZMR - ODE .
ZMS ZMT - ODF .
ZMU ZMV - ODG .
ZMW ZMX - ODH .
ZNA ZNB - ODI .
ZNC ZND - ODJ .
ZNE ZNF - ODK .
ZNG ZNH - ODL .
ZNI ZNJ - ODM .
ZNK ZNL - ODN .
ZNM ZNN - ODO .
ZNO ZNP - ODP .
ZNQ ZNR - OEA .
ZNS ZNT - OEB .
ZNU ZNV - OEC .
ZNW ZNX - OED .
ZOA ZOB - OEE .
ZOC ZOD - OEF .
ZOE ZOF - OEG .
ZOG ZOH - OEH .
ZOI ZOJ - OEI .
ZOK ZOL - OEJ .
ZOM ZON - OEK .
ZOO ZOP - OEL .
ZOQ ZOR - OEM .
ZOS ZOT - OEN .
ZOU ZOV - OEO .
ZOW ZOX - OEP .

ZPA ZPB - OFA .
ZPC ZPD - OFB .
ZPE ZPF - OFC .
ZPG ZPH - OFD .
ZPI ZPJ - OFE .
ZPK ZPL - OFF .
ZPM ZPN - OFG .
ZPO ZPP - OFH .
ZPQ ZPR - OFI .
ZPS ZPT - OFJ .
ZPU ZPV - OFK .
ZPW ZPX - OFL .
ZQA ZQB - OFM .
ZQC ZQD - OFN .
ZQE ZQF - OFO .
ZQG ZQH - OFP .
ZQI ZQJ - IFA .  
ZQK ZQL - IFB .  
ZQM ZQN - IFC .  
ZQO ZQP - IFD . 
ZQQ ZQR - IFE . 
ZQS ZQT - IFF . 
ZQU ZQV - IFG . 
ZQW ZQX - IFH . 
ZRA ZRB - IFI . 
ZRC ZRD - IFJ . 
ZRE ZRF - IFK . 
ZRG ZRH - IFL . 
ZRI ZRJ - IFM . 
ZRK ZRL - IFN .  
ZRM ZRN - IFO .  
ZRO ZRP - IFP .  
ZRQ ZRR - IEO .  
ZRS ZRT - IEP .  
ZRU ZRV - IIA .  
ZRW ZRX - *** .  

ZSA ZSB - IGO .  
ZSC ZSD - IGP .  
ZSE ZSF - *** .  
ZSG ZSH - *** .  
ZSI ZSJ - *** .  
ZSK ZSL - *** .  
ZSM ZSN - *** .  
ZSO ZSP - *** .  
ZSQ ZSR - *** .  
ZSS ZST - *** .  
ZSU ZSV - *** .  
ZSW ZSX - *** .  
ZTA ZTB - *** .  
ZTC ZTD - *** .  
ZTE ZTF - *** .  
ZTG ZTH - *** .  
ZTI ZTJ - *** .  
ZTK ZTL - *** .  
ZTM ZTN - *** .  
ZTO ZTP - *** .  
ZTQ ZTR - *** .  
ZTS ZTT - *** .  
ZTU ZTV - *** .  
ZTW ZTX - *** .  
ZUA ZUB - *** .  
ZUC ZUD - *** .  
ZUE ZUF - *** .  
ZUG ZUH - *** .  
ZUI ZUJ - *** .  
ZUK ZUL - *** .  
ZUM ZUN - *** .  
ZUO ZUP - *** .  
ZUQ ZUR - *** .  
ZUS ZUT - *** .  
ZUU ZUV - *** .  
ZUW ZUX - *** .  

ZVA ZVB - *** .  
ZVC ZVD - *** .  
ZVE ZVF - *** .  
ZVG ZVH - *** .  
ZVI ZVJ - *** .  
ZVK ZVL - *** .  
ZVM ZVN - *** .  
ZVO ZVP - *** .  
ZVQ ZVR - *** .  
ZVS ZVT - *** .  
ZVU ZVV - *** .  
ZVW ZVX - *** .  
ZWA ZWB - *** .  
ZWC ZWD - *** .  
ZWE ZWF - *** .  
ZWG ZWH - *** .  
ZWI ZWJ - *** .  
ZWK ZWL - *** .  
ZWM ZWN - *** .  
ZWO ZWP - *** .  
ZWQ ZWR - *** .  
ZWS ZWT - *** .  
ZWU ZWV - *** .  
ZWW ZWX - *** .  
ZXA ZXB - *** .  
ZXC ZXD - *** .  
ZXE ZXF - *** .  
ZXG ZXH - *** .  
ZXI ZXJ - *** .  
ZXK ZXL - *** .  
ZXM ZXN - *** .  
ZXO ZXP - *** .  
ZXQ ZXR - *** .  
ZXS ZXT - *** .  
ZXU ZXV - *** .  
ZXW ZXX - *** .
